,Revenue,COGS,Gross Profit,Gross Profit Ratio,Research and Development Exp.,General and Administrative Exp.,Selling and Marketing Exp.,"Selling, General and Administrative Exp.",Other Expenses,Operating Expenses,COGS and Expenses,Interest Income,Interest Expense (Gain),Depreciation and Amortization,EBITDA,EBITDA Ratio,Operating Income,Operating Income Ratio,Total Other Income Expenses (Gains),Income Before Tax,Income Before Tax Ratio,Income Tax expense (Gain),Net Income,Net Income Ratio,EPS,EPS Diluted,Weighted Average Shares Outstanding,Weighted Average Shares Outstanding Diluted,Cash and Cash Equivalents,Short-Term Investments,Cash and Short-Term Investments,Net Receivables,Inventory (Balance),Other Current Assets,Total Current Assets,PP&E,Goodwill,Intangible Assets,Goodwill and Intangible Assets,Investments,Tax Assets,Other Non-Current Assets,Total Non-Current Assets,Other Assets,Total Assets,Accounts Payable (Balance),Short-Term Debt,Tax Payable,Deferred Revenue (Current),Other Current Liabilities,Total Current Liabilities,Long-Term Debt,Deferred Revenue (Non-Current),Deferred Tax Liabilities,Other Non-Current Liabilities,Total Non-Current Liabilities,Other Liabilities,Capital Lease Obligations,Total Liabilities,Preferred Stock,Common Stock,Retained Earnings,Other Comprehensive Income/Loss,Other Total Stockholders Equity,Total Stockholders Equity,Total Liabilities And Stockholders Equity,Minority Interest,Total Liabilities & Equity,Net Income (Cash Flow),Depreciation and Amortization (Cash Flow),Deferred Income Tax,Stock Based Compensation,Change in Working Capital,Accounts Receivable,Inventory (Cash Flow),Accounts Payable (Cash Flow),Other Working Capital,Other Non-Cash Items,Cash Provided by Operating Activities,CAPEX,Acquisitions Net,Purchases of Investments,Sales/Maturities of Investments,Other Investing Activities,Cash Used for Investing Activites,Debt Repayment,Common Stock Issued,Common Stock Repurchased,Dividends Paid,Other Financing Activites,Cash Used/Provided by Financing Activities,Effect of Forex Changes on Cash,Net Change In Cash,Cash at the End of Period,Cash at the Beginning of Period,Free Cash Flow
2006,,,,,,100000,,100000,,100000,100000,,,,-100000,-Infinity,-100000,-Infinity,,-100000,-Infinity,,-100000,-Infinity,-0.03,-0.03,3500000,3500000,,,,,,,,,,,,,,,,,,,,,,,,,,,100000,,100000,,100000,,,-100000,,,-100000,,,,-100000,,,,100000,,,,,,,,,,,,,,,,,,,,,,,
2007,7660000,,,,,,,,6000000,6000000,6029000,,,,1631000,0.2129,,,24000,1631000,0.2129,614000,1017000,0.1328,0.29,0.29,3454667,3454667,15729000,17055000,32784000,3256000,,,,36000,,,,17055000,,,,39993000,39993000,1893000,,1266000,,,,,,,,,25655000,,25655000,,13383000,955000,,,14338000,39993000,,39993000,1017000,,-653000,,,-3256000,,,,19500000,19864000,-36000,,-17055000,,-36000,-17091000,,12955000,,,,12955000,,15728000,15729000,1000,19828000
2008,49533000,,,,,,,,29000000,29000000,28738000,,,37000,20832000,0.4206,20795000,0.4198,,20795000,0.4198,8140000,12655000,0.2555,2.15,2.08,5892000,6070000,81060000,27582000,108642000,5534000,,-33116000,81060000,267000,,,,27582000,,-27582000,267000,,81327000,6136000,,4704000,,-2573000,3563000,,,,,,91033000,,94596000,,,13610000,,23783000,37393000,131989000,-50662000,81327000,12655000,37000,-2910000,466000,77497000,-1765000,,,77497000,-21103000,66642000,-268000,,-10527000,,-450000,-11245000,,9798000,,,136000,9934000,,65331000,81060000,15729000,66374000
2009,68378000,,,,,,,,51000000,51000000,50629000,,,74000,17823000,0.2607,,,1248000,17749000,0.2596,6839000,10910000,0.1596,1.62,1.52,6734568,7177632,43453000,11521000,54974000,5075000,,-16596000,43453000,399000,,,,34836000,,-34836000,399000,,43852000,,,167000,,2438000,2438000,,,,,,90076000,,92514000,,,24520000,-306000,20858000,45378000,137892000,-94040000,43852000,10910000,74000,1316000,483000,-36482000,122000,,,41015000,10225000,-13474000,-314000,,-30066000,9349000,,-21031000,,,-3111000,,9000,-3102000,,-37607000,43453000,81060000,-13788000
2010,68615000,,,,,,,,60000000,60000000,60029000,,,178000,8764000,0.1277,,,2215000,8586000,0.1251,3164000,5422000,0.0790,0.88,0.81,6179000,6674000,54849000,,54849000,6002000,,-6002000,54849000,7755000,,,,29448000,,-29448000,7755000,,62604000,,,310000,,584000,584000,,,,,,93735000,,94319000,,,28065000,-42000,18564000,46629000,140948000,-78344000,62604000,5422000,178000,1690000,87000,13250000,-923000,,,54265000,-4496000,16131000,-7534000,,-37305000,45152000,-526000,-213000,,,-3596000,-1877000,951000,-4522000,,11396000,54849000,43453000,8597000
2011,94839000,,,,,,,,77000000,77000000,78434000,,,576000,16981000,0.1791,,,3708000,16405000,0.1730,6441000,9964000,0.1051,1.49,1.34,6132000,7445000,100355000,,100355000,12630000,,-12630000,100355000,10499000,161000,,161000,39849000,,63954000,114463000,,214818000,,,4956000,,2368000,2368000,,,,4956000,4956000,153576000,,150988000,,,33986000,208000,29844000,63830000,214818000,,214818000,9964000,576000,-1984000,27000,43722000,-6400000,,,97987000,3728000,56033000,-3144000,-5309000,-38000000,27896000,1606000,-16951000,,,-1887000,-3825000,12136000,6424000,,45506000,100355000,54849000,52889000
2012,162886000,,,,,,,,113000000,113000000,113306000,,,1591000,51171000,0.3142,,,1424000,49580000,0.3044,19423000,30157000,0.1851,3.45,3.02,8647826,9879139,230214000,44829000,275043000,11017000,,-285954000,106000,10853000,,,,44829000,,221315000,276997000,,277103000,1377000,,8813000,,2471000,3848000,,,,8813000,8813000,222000000,,217035000,,,55758000,1620000,63495000,121253000,338288000,-61185000,277103000,30157000,1591000,-2366000,844000,-101729000,3267000,,1377000,-3742000,177769000,106266000,-1196000,-8157000,-5711000,13853000,,-1211000,,20082000,,-8561000,13278000,24799000,5000,129859000,230214000,100355000,105070000
2013,241088000,,,,,,,,135000000,135000000,134635000,,3607000,2103000,112163000,0.4652,106453000,0.4416,,106453000,0.4416,40891000,65562000,0.2719,5.82,5.63,11247079,11626643,293398000,129800000,423198000,24622000,,-447765000,55000,13132000,,,,129800000,,-70716000,72216000,,72271000,4660000,,543000,,234240000,238900000,126932000,,2740000,-2772000,126900000,,,365795000,,,110441000,1114000,49080000,160521000,526316000,-454045000,72271000,65562000,2103000,557000,5365000,-235103000,-4032000,,3283000,-238845000,216988000,55472000,-3433000,,-94780000,8172000,1000,-90040000,,,-30886000,-10902000,139540000,97752000,,63184000,293398000,230214000,52039000
2014,266108000,,,,,16483000,,16483000,148517000,165000000,165146000,,10453000,4958000,116373000,0.4373,100962000,0.3794,,100962000,0.3794,38298000,62664000,0.2355,5.90,5.36,10621695,11691791,314716000,142634000,457350000,47630000,,-504892000,88000,12292000,,,,149661000,,-59082000,102871000,,102959000,218000,,,,289868000,290086000,129539000,,,-3653000,125886000,255425000,,419625000,,,161454000,666000,20131000,182585000,602210000,-499251000,102959000,62664000,4958000,-4742000,8110000,-51153000,-1150000,,-4442000,-289998000,68892000,88729000,-453000,-4500000,-130262000,119778000,-3215000,-18652000,,,-39031000,-12355000,2656000,-48730000,-29000,21318000,314716000,293398000,88276000
2015,285952000,,,,,20140000,,20140000,159860000,180000000,179760000,,10754000,5251000,122197000,0.4273,,,1261000,106192000,0.3714,40331000,65861000,0.2303,6.51,5.90,10116897,11162881,267738000,173246000,440984000,58595000,,-499534000,45000,11786000,,,,201963000,,-97049000,116700000,,116745000,1084000,,,4983000,263768000,269835000,129429000,4983000,,-4983000,129429000,,,399264000,,,215634000,-1791000,24088000,237722000,636986000,-520241000,116745000,65861000,5251000,-1101000,5212000,20208000,-3807000,,866000,-269790000,-50161000,45270000,-840000,-435000,-156015000,88750000,-11822000,-80362000,,,-2402000,-12428000,3305000,-11525000,-61000,-46678000,267738000,314416000,44430000
2016,258217000,,,,,19037000,,19037000,198963000,218000000,211361000,,11079000,5408000,63343000,0.2453,,,1470000,46856000,0.1815,17835000,29021000,0.1124,2.95,2.92,9837627,9938699,280531000,219283000,499814000,27551000,,-527277000,88000,11374000,,4899000,4899000,250648000,,-193398000,73523000,,73611000,3294000,,,,284161000,287455000,138863000,4651000,,-4651000,138863000,,,426318000,,,232964000,2643000,7782000,243746000,670064000,-596453000,73611000,29021000,5408000,155000,4198000,-17577000,2355000,,2210000,-287367000,66770000,87975000,-865000,-11741000,-112634000,68273000,7939000,-49028000,-11802000,,-20490000,-12438000,18573000,-26157000,3000,12793000,280531000,267738000,87110000
2017,244406000,,,,,25127000,,25127000,234873000,260000000,260030000,,16767000,9591000,10734000,0.0439,,,1756000,-15624000,-0.0639,-8731000,-6893000,-0.0282,-0.75,-0.75,8558000,8558000,255884000,296395000,552279000,141479000,,-693742000,16000,12465000,,4995000,4995000,321928000,,-151101000,188287000,,188303000,15000,89990000,,,320449000,410454000,237835000,4948000,1890000,-6838000,237835000,,,648289000,,,189409000,4566000,,193975000,842264000,-653961000,188303000,-6893000,9591000,-4913000,4523000,-123071000,-103635000,,-3279000,-410438000,137189000,16426000,-2977000,,-169422000,91938000,-340000,-80164000,-41224000,,-45872000,-13906000,140032000,39030000,61000,-24647000,255884000,280531000,13449000
2018,231292000,,,,,25908000,,25908000,178092000,204000000,204390000,,18096000,10996000,55994000,0.2421,,,1999000,26902000,0.1163,9177000,17725000,0.0766,2.34,2.34,7878000,7895000,239458000,249202000,488660000,146477000,,-635109000,28000,13338000,,4800000,4800000,323483000,,168638000,510259000,,510287000,14000,,,,401258000,401272000,250095000,,1068000,-1013000,250150000,,55000,651422000,,,182894000,-1453000,,181441000,832863000,-322576000,510287000,17725000,10996000,141000,4632000,9194000,-19667000,,-1000,-401244000,-14093000,28595000,-2596000,,-374144000,365681000,-7028000,-17678000,-1127000,,-21166000,-11318000,6323000,-27288000,-164000,-16535000,240158000,256693000,25999000
2019,242474000,,,,,31112000,,31112000,174888000,206000000,206381000,,12898000,8942000,57933000,0.2389,,,1882000,36093000,0.1489,9517000,26576000,0.1096,3.32,3.31,7580000,10238000,229218000,203330000,432548000,165069000,,-597563000,54000,14698000,,4192000,4192000,267723000,,-74963000,211650000,,211704000,76000,9750000,,,443605000,453431000,163635000,,4008000,-4008000,163635000,,60000,617066000,,,183365000,2178000,178000,185543000,802609000,-590905000,211704000,26576000,8942000,1871000,6460000,-52133000,-12355000,,62000,-453377000,62331000,54047000,-2887000,,-109651000,172357000,-9360000,50459000,-91318000,,-20054000,-13012000,9660000,-114724000,-22000,-10240000,229918000,240158000,51160000
2020,311048000,,310437000,0.9980,,33829000,,33829000,-20026000,13803000,274120000,,11576000,8747000,57251000,0.1841,296634000,0.9537,-259706000,36928000,0.1187,9348000,27580000,0.0887,3.55,3.49,7351000,9694000,431341000,71722000,503063000,169590000,,-672576000,77000,16769000,,3568000,3568000,151248000,,,171585000,1112821000,941313000,87000,27764000,,11925000,-27851000,11925000,156468000,,11925000,-11882000,156511000,884763000,4057000,740177000,,12000,199592000,1544000,-12000,201136000,941313000,,941313000,27580000,8747000,8123000,8133000,441529000,-680000,,11000,-11848000,-416801000,77311000,-6437000,,-107615000,214201000,43066000,143215000,-21507000,,-6708000,-12694000,24204000,-16705000,2000,203823000,433741000,229918000,70874000
2021,407915000,,,,,45428000,,45428000,,45428000,,,6400000,,17633000,0.0432,11233000,0.0275,,11233000,0.0275,3991000,7242000,0.0178,0.90,0.90,8023000,8023000,96000,196000,292000,,,,292000,,,,,,11739000,,11739000,,1176000,,,11000,,,,45504000,,,,45504000,,,762000,,13000,,498000,323992000,324503000,325265000,-324089000,1176000,7242000,,,,12140000,,,,292000,-19382000,,-3318000,,-2674000,26684000,16160000,36852000,-8750000,,-1314000,-14065000,88430000,64301000,-54000,197602000,631343000,433741000,-3318000
