,Revenue,COGS,Gross Profit,Gross Profit Ratio,Research and Development Exp.,"Selling, General and Administrative Exp.",Other Expenses,Operating Expenses,COGS and Expenses,Interest Income,Interest Expense (Gain),Depreciation and Amortization,EBITDA,EBITDA Ratio,Operating Income,Operating Income Ratio,Total Other Income Expenses (Gains),Income Before Tax,Income Before Tax Ratio,Income Tax expense (Gain),Net Income,Net Income Ratio,EPS,EPS Diluted,Weighted Average Shares Outstanding,Weighted Average Shares Outstanding Diluted,Cash and Cash Equivalents,Short-Term Investments,Cash and Short-Term Investments,Net Receivables,Inventory (Balance),Other Current Assets,Total Current Assets,PP&E,Goodwill,Intangible Assets,Goodwill and Intangible Assets,Investments,Tax Assets,Other Non-Current Assets,Total Non-Current Assets,Other Assets,Total Assets,Accounts Payable (Balance),Short-Term Debt,Tax Payable,Deferred Revenue (Current),Other Current Liabilities,Total Current Liabilities,Long-Term Debt,Deferred Revenue (Non-Current),Deferred Tax Liabilities,Other Non-Current Liabilities,Total Non-Current Liabilities,Other Liabilities,Capital Lease Obligations,Total Liabilities,Preferred Stock,Common Stock,Retained Earnings,Other Comprehensive Income/Loss,Other Total Stockholders Equity,Total Stockholders Equity,Total Liabilities And Stockholders Equity,Minority Interest,Total Liabilities & Equity,Net Income (Cash Flow),Depreciation and Amortization (Cash Flow),Deferred Income Tax,Stock Based Compensation,Change in Working Capital,Accounts Receivable,Inventory (Cash Flow),Accounts Payable (Cash Flow),Other Working Capital,Other Non-Cash Items,Cash Provided by Operating Activities,CAPEX,Acquisitions Net,Purchases of Investments,Sales/Maturities of Investments,Other Investing Activities,Cash Used for Investing Activites,Debt Repayment,Common Stock Issued,Common Stock Repurchased,Dividends Paid,Other Financing Activites,Cash Used/Provided by Financing Activities,Effect of Forex Changes on Cash,Net Change In Cash,Cash at the End of Period,Cash at the Beginning of Period,Free Cash Flow,Open,Close,Adj Close,Volume,Dividend,Dividend Cum,Price with cum Dividends,Tax Rate,Deferred Revenue,Net Interest Income,Free Cash Flow to the Firm,Tangible Assets,Adjusted Operating Income,EBIT,Operating Cash Flow,Common Book Value,Tangible Book Value,Common Tangible Book Value,Free Cash Flow Ratio,"Selling, General and Administrative Exp. Ratio",Research and Development Exp. Ratio,Other Expenses Ratio,Net Interest IncomeRatio,Depreciation and Amortization Ratio,EBIT Margin,Adjusted Operating Margin,Operating Cash Flow Margin,Cost-to-Income Ratio,Operating Expense Ratio,Revenue per share,Operating Income per share,FCF per share,CAPEX per share,Book value per share,Dividends per share,Total Debt,Financial leverage,Cash to Debt Ratio,Cash & Investments,Cash & Investments to Debt Ratio,Net Debt,Net Debt w/Investments,Working Capital,Current Ratio,Quick Ratio,Cash to Current Assets,Cash to Assets,Debt to Equity,Debt to Assets,Interest Coverage,Current Liability Coverage Ratio,Cash Ratio,Net Working Capital to Assets,Long Term Debt Ratio,Total Debt/ Assets,Net Debt/ Assets,Total Debt/ Equity,Total Liabilities/ Equity,Net Debt/ Equity,Equity Ratio,Equity Multiplier,Debt/ Tangible Book Value,Net Debt/ EBITDA,Cash to Debt,Cash Flow Coverage Ratio,Free Cash Flow/ Long Term Debt,Debt Leverage Ratio,Interest Expense to Debt Ratio,Cash Sales,Cash Revenue Adjustment,CFO/ Net Income,Return on Equity,NOPAT,Invested Capital,Return on Invested Capital,Capital Employed,ROCE,CFROI,Asset Turnover Ratio,Inventory Turnover,Receivables Turnover,Cash Turnover Ratio,Gross Profitability Ratio,Tangible Gross Profitability Ratio,Cash Return on Invested Capital,Adjusted Return on Capital Employed,Cash Return on Capital Employed,EBIT Return on Assets,EBIT Return on Tangible Assets,Return on Assets,Return on Tangible Equity,Cash Return on Equity,Return on Retained Earnings,R&D / Assets,R&D / Book,CapEx / Assets,CapEx / Fixed Assets,Retained Earnings / Total Assets,Inventory / Assets,Accounts Receivable / Assets,Plowback Ratio,Dividend & Repurchase / FCF,Dividend & Repurchase / EBITDA,Revenue growth year over year,Revenue growth 3 year average,Revenue growth 5 year average,Revenue growth 10 year average,COGS growth year over year,COGS growth 3 year average,COGS growth 5 year average,COGS growth 10 year average,Gross Profit growth year over year,Gross Profit growth 3 year average,Gross Profit growth 5 year average,Gross Profit growth 10 year average,Gross Profit Ratio growth year over year,Gross Profit Ratio growth 3 year average,Gross Profit Ratio growth 5 year average,Gross Profit Ratio growth 10 year average,Research and Development Exp. growth year over year,Research and Development Exp. growth 3 year average,Research and Development Exp. growth 5 year average,Research and Development Exp. growth 10 year average,"Selling, General and Administrative Exp. growth year over year","Selling, General and Administrative Exp. growth 3 year average","Selling, General and Administrative Exp. growth 5 year average","Selling, General and Administrative Exp. growth 10 year average",Other Expenses growth year over year,Other Expenses growth 3 year average,Other Expenses growth 5 year average,Other Expenses growth 10 year average,Operating Expenses growth year over year,Operating Expenses growth 3 year average,Operating Expenses growth 5 year average,Operating Expenses growth 10 year average,COGS and Expenses growth year over year,COGS and Expenses growth 3 year average,COGS and Expenses growth 5 year average,COGS and Expenses growth 10 year average,Interest Income growth year over year,Interest Income growth 3 year average,Interest Income growth 5 year average,Interest Income growth 10 year average,Interest Expense (Gain) growth year over year,Interest Expense (Gain) growth 3 year average,Interest Expense (Gain) growth 5 year average,Interest Expense (Gain) growth 10 year average,Depreciation and Amortization growth year over year,Depreciation and Amortization growth 3 year average,Depreciation and Amortization growth 5 year average,Depreciation and Amortization growth 10 year average,EBITDA growth year over year,EBITDA growth 3 year average,EBITDA growth 5 year average,EBITDA growth 10 year average,EBITDA Ratio growth year over year,EBITDA Ratio growth 3 year average,EBITDA Ratio growth 5 year average,EBITDA Ratio growth 10 year average,Operating Income growth year over year,Operating Income growth 3 year average,Operating Income growth 5 year average,Operating Income growth 10 year average,Operating Income Ratio growth year over year,Operating Income Ratio growth 3 year average,Operating Income Ratio growth 5 year average,Operating Income Ratio growth 10 year average,Total Other Income Expenses (Gains) growth year over year,Total Other Income Expenses (Gains) growth 3 year average,Total Other Income Expenses (Gains) growth 5 year average,Total Other Income Expenses (Gains) growth 10 year average,Income Before Tax growth year over year,Income Before Tax growth 3 year average,Income Before Tax growth 5 year average,Income Before Tax growth 10 year average,Income Before Tax Ratio growth year over year,Income Before Tax Ratio growth 3 year average,Income Before Tax Ratio growth 5 year average,Income Before Tax Ratio growth 10 year average,Income Tax expense (Gain) growth year over year,Income Tax expense (Gain) growth 3 year average,Income Tax expense (Gain) growth 5 year average,Income Tax expense (Gain) growth 10 year average,Net Income growth year over year,Net Income growth 3 year average,Net Income growth 5 year average,Net Income growth 10 year average,Net Income Ratio growth year over year,Net Income Ratio growth 3 year average,Net Income Ratio growth 5 year average,Net Income Ratio growth 10 year average,EPS growth year over year,EPS growth 3 year average,EPS growth 5 year average,EPS growth 10 year average,EPS Diluted growth year over year,EPS Diluted growth 3 year average,EPS Diluted growth 5 year average,EPS Diluted growth 10 year average,Weighted Average Shares Outstanding growth year over year,Weighted Average Shares Outstanding growth 3 year average,Weighted Average Shares Outstanding growth 5 year average,Weighted Average Shares Outstanding growth 10 year average,Weighted Average Shares Outstanding Diluted growth year over year,Weighted Average Shares Outstanding Diluted growth 3 year average,Weighted Average Shares Outstanding Diluted growth 5 year average,Weighted Average Shares Outstanding Diluted growth 10 year average,Cash and Cash Equivalents growth year over year,Cash and Cash Equivalents growth 3 year average,Cash and Cash Equivalents growth 5 year average,Cash and Cash Equivalents growth 10 year average,Short-Term Investments growth year over year,Short-Term Investments growth 3 year average,Short-Term Investments growth 5 year average,Short-Term Investments growth 10 year average,Cash and Short-Term Investments growth year over year,Cash and Short-Term Investments growth 3 year average,Cash and Short-Term Investments growth 5 year average,Cash and Short-Term Investments growth 10 year average,Net Receivables growth year over year,Net Receivables growth 3 year average,Net Receivables growth 5 year average,Net Receivables growth 10 year average,Inventory (Balance) growth year over year,Inventory (Balance) growth 3 year average,Inventory (Balance) growth 5 year average,Inventory (Balance) growth 10 year average,Other Current Assets growth year over year,Other Current Assets growth 3 year average,Other Current Assets growth 5 year average,Other Current Assets growth 10 year average,Total Current Assets growth year over year,Total Current Assets growth 3 year average,Total Current Assets growth 5 year average,Total Current Assets growth 10 year average,PP&E growth year over year,PP&E growth 3 year average,PP&E growth 5 year average,PP&E growth 10 year average,Goodwill growth year over year,Goodwill growth 3 year average,Goodwill growth 5 year average,Goodwill growth 10 year average,Intangible Assets growth year over year,Intangible Assets growth 3 year average,Intangible Assets growth 5 year average,Intangible Assets growth 10 year average,Goodwill and Intangible Assets growth year over year,Goodwill and Intangible Assets growth 3 year average,Goodwill and Intangible Assets growth 5 year average,Goodwill and Intangible Assets growth 10 year average,Investments growth year over year,Investments growth 3 year average,Investments growth 5 year average,Investments growth 10 year average,Tax Assets growth year over year,Tax Assets growth 3 year average,Tax Assets growth 5 year average,Tax Assets growth 10 year average,Other Non-Current Assets growth year over year,Other Non-Current Assets growth 3 year average,Other Non-Current Assets growth 5 year average,Other Non-Current Assets growth 10 year average,Total Non-Current Assets growth year over year,Total Non-Current Assets growth 3 year average,Total Non-Current Assets growth 5 year average,Total Non-Current Assets growth 10 year average,Other Assets growth year over year,Other Assets growth 3 year average,Other Assets growth 5 year average,Other Assets growth 10 year average,Total Assets growth year over year,Total Assets growth 3 year average,Total Assets growth 5 year average,Total Assets growth 10 year average,Accounts Payable (Balance) growth year over year,Accounts Payable (Balance) growth 3 year average,Accounts Payable (Balance) growth 5 year average,Accounts Payable (Balance) growth 10 year average,Short-Term Debt growth year over year,Short-Term Debt growth 3 year average,Short-Term Debt growth 5 year average,Short-Term Debt growth 10 year average,Tax Payable growth year over year,Tax Payable growth 3 year average,Tax Payable growth 5 year average,Tax Payable growth 10 year average,Deferred Revenue (Current) growth year over year,Deferred Revenue (Current) growth 3 year average,Deferred Revenue (Current) growth 5 year average,Deferred Revenue (Current) growth 10 year average,Other Current Liabilities growth year over year,Other Current Liabilities growth 3 year average,Other Current Liabilities growth 5 year average,Other Current Liabilities growth 10 year average,Total Current Liabilities growth year over year,Total Current Liabilities growth 3 year average,Total Current Liabilities growth 5 year average,Total Current Liabilities growth 10 year average,Long-Term Debt growth year over year,Long-Term Debt growth 3 year average,Long-Term Debt growth 5 year average,Long-Term Debt growth 10 year average,Deferred Revenue (Non-Current) growth year over year,Deferred Revenue (Non-Current) growth 3 year average,Deferred Revenue (Non-Current) growth 5 year average,Deferred Revenue (Non-Current) growth 10 year average,Deferred Tax Liabilities growth year over year,Deferred Tax Liabilities growth 3 year average,Deferred Tax Liabilities growth 5 year average,Deferred Tax Liabilities growth 10 year average,Other Non-Current Liabilities growth year over year,Other Non-Current Liabilities growth 3 year average,Other Non-Current Liabilities growth 5 year average,Other Non-Current Liabilities growth 10 year average,Total Non-Current Liabilities growth year over year,Total Non-Current Liabilities growth 3 year average,Total Non-Current Liabilities growth 5 year average,Total Non-Current Liabilities growth 10 year average,Other Liabilities growth year over year,Other Liabilities growth 3 year average,Other Liabilities growth 5 year average,Other Liabilities growth 10 year average,Capital Lease Obligations growth year over year,Capital Lease Obligations growth 3 year average,Capital Lease Obligations growth 5 year average,Capital Lease Obligations growth 10 year average,Total Liabilities growth year over year,Total Liabilities growth 3 year average,Total Liabilities growth 5 year average,Total Liabilities growth 10 year average,Preferred Stock growth year over year,Preferred Stock growth 3 year average,Preferred Stock growth 5 year average,Preferred Stock growth 10 year average,Common Stock growth year over year,Common Stock growth 3 year average,Common Stock growth 5 year average,Common Stock growth 10 year average,Retained Earnings growth year over year,Retained Earnings growth 3 year average,Retained Earnings growth 5 year average,Retained Earnings growth 10 year average,Other Comprehensive Income/Loss growth year over year,Other Comprehensive Income/Loss growth 3 year average,Other Comprehensive Income/Loss growth 5 year average,Other Comprehensive Income/Loss growth 10 year average,Other Total Stockholders Equity growth year over year,Other Total Stockholders Equity growth 3 year average,Other Total Stockholders Equity growth 5 year average,Other Total Stockholders Equity growth 10 year average,Total Stockholders Equity growth year over year,Total Stockholders Equity growth 3 year average,Total Stockholders Equity growth 5 year average,Total Stockholders Equity growth 10 year average,Total Liabilities And Stockholders Equity growth year over year,Total Liabilities And Stockholders Equity growth 3 year average,Total Liabilities And Stockholders Equity growth 5 year average,Total Liabilities And Stockholders Equity growth 10 year average,Minority Interest growth year over year,Minority Interest growth 3 year average,Minority Interest growth 5 year average,Minority Interest growth 10 year average,Total Liabilities & Equity growth year over year,Total Liabilities & Equity growth 3 year average,Total Liabilities & Equity growth 5 year average,Total Liabilities & Equity growth 10 year average,Net Income (Cash Flow) growth year over year,Net Income (Cash Flow) growth 3 year average,Net Income (Cash Flow) growth 5 year average,Net Income (Cash Flow) growth 10 year average,Depreciation and Amortization (Cash Flow) growth year over year,Depreciation and Amortization (Cash Flow) growth 3 year average,Depreciation and Amortization (Cash Flow) growth 5 year average,Depreciation and Amortization (Cash Flow) growth 10 year average,Deferred Income Tax growth year over year,Deferred Income Tax growth 3 year average,Deferred Income Tax growth 5 year average,Deferred Income Tax growth 10 year average,Stock Based Compensation growth year over year,Stock Based Compensation growth 3 year average,Stock Based Compensation growth 5 year average,Stock Based Compensation growth 10 year average,Change in Working Capital growth year over year,Change in Working Capital growth 3 year average,Change in Working Capital growth 5 year average,Change in Working Capital growth 10 year average,Accounts Receivable growth year over year,Accounts Receivable growth 3 year average,Accounts Receivable growth 5 year average,Accounts Receivable growth 10 year average,Inventory (Cash Flow) growth year over year,Inventory (Cash Flow) growth 3 year average,Inventory (Cash Flow) growth 5 year average,Inventory (Cash Flow) growth 10 year average,Accounts Payable (Cash Flow) growth year over year,Accounts Payable (Cash Flow) growth 3 year average,Accounts Payable (Cash Flow) growth 5 year average,Accounts Payable (Cash Flow) growth 10 year average,Other Working Capital growth year over year,Other Working Capital growth 3 year average,Other Working Capital growth 5 year average,Other Working Capital growth 10 year average,Other Non-Cash Items growth year over year,Other Non-Cash Items growth 3 year average,Other Non-Cash Items growth 5 year average,Other Non-Cash Items growth 10 year average,Cash Provided by Operating Activities growth year over year,Cash Provided by Operating Activities growth 3 year average,Cash Provided by Operating Activities growth 5 year average,Cash Provided by Operating Activities growth 10 year average,CAPEX growth year over year,CAPEX growth 3 year average,CAPEX growth 5 year average,CAPEX growth 10 year average,Acquisitions Net growth year over year,Acquisitions Net growth 3 year average,Acquisitions Net growth 5 year average,Acquisitions Net growth 10 year average,Purchases of Investments growth year over year,Purchases of Investments growth 3 year average,Purchases of Investments growth 5 year average,Purchases of Investments growth 10 year average,Sales/Maturities of Investments growth year over year,Sales/Maturities of Investments growth 3 year average,Sales/Maturities of Investments growth 5 year average,Sales/Maturities of Investments growth 10 year average,Other Investing Activities growth year over year,Other Investing Activities growth 3 year average,Other Investing Activities growth 5 year average,Other Investing Activities growth 10 year average,Cash Used for Investing Activites growth year over year,Cash Used for Investing Activites growth 3 year average,Cash Used for Investing Activites growth 5 year average,Cash Used for Investing Activites growth 10 year average,Debt Repayment growth year over year,Debt Repayment growth 3 year average,Debt Repayment growth 5 year average,Debt Repayment growth 10 year average,Common Stock Issued growth year over year,Common Stock Issued growth 3 year average,Common Stock Issued growth 5 year average,Common Stock Issued growth 10 year average,Common Stock Repurchased growth year over year,Common Stock Repurchased growth 3 year average,Common Stock Repurchased growth 5 year average,Common Stock Repurchased growth 10 year average,Dividends Paid growth year over year,Dividends Paid growth 3 year average,Dividends Paid growth 5 year average,Dividends Paid growth 10 year average,Other Financing Activites growth year over year,Other Financing Activites growth 3 year average,Other Financing Activites growth 5 year average,Other Financing Activites growth 10 year average,Cash Used/Provided by Financing Activities growth year over year,Cash Used/Provided by Financing Activities growth 3 year average,Cash Used/Provided by Financing Activities growth 5 year average,Cash Used/Provided by Financing Activities growth 10 year average,Effect of Forex Changes on Cash growth year over year,Effect of Forex Changes on Cash growth 3 year average,Effect of Forex Changes on Cash growth 5 year average,Effect of Forex Changes on Cash growth 10 year average,Net Change In Cash growth year over year,Net Change In Cash growth 3 year average,Net Change In Cash growth 5 year average,Net Change In Cash growth 10 year average,Cash at the End of Period growth year over year,Cash at the End of Period growth 3 year average,Cash at the End of Period growth 5 year average,Cash at the End of Period growth 10 year average,Cash at the Beginning of Period growth year over year,Cash at the Beginning of Period growth 3 year average,Cash at the Beginning of Period growth 5 year average,Cash at the Beginning of Period growth 10 year average,Free Cash Flow growth year over year,Free Cash Flow growth 3 year average,Free Cash Flow growth 5 year average,Free Cash Flow growth 10 year average,Open growth year over year,Open growth 3 year average,Open growth 5 year average,Open growth 10 year average,Close growth year over year,Close growth 3 year average,Close growth 5 year average,Close growth 10 year average,Adj Close growth year over year,Adj Close growth 3 year average,Adj Close growth 5 year average,Adj Close growth 10 year average,Volume growth year over year,Volume growth 3 year average,Volume growth 5 year average,Volume growth 10 year average,Dividend growth year over year,Dividend growth 3 year average,Dividend growth 5 year average,Dividend growth 10 year average,Dividend Cum growth year over year,Dividend Cum growth 3 year average,Dividend Cum growth 5 year average,Dividend Cum growth 10 year average,Price with cum Dividends growth year over year,Price with cum Dividends growth 3 year average,Price with cum Dividends growth 5 year average,Price with cum Dividends growth 10 year average,Tax Rate growth year over year,Tax Rate growth 3 year average,Tax Rate growth 5 year average,Tax Rate growth 10 year average,Deferred Revenue growth year over year,Deferred Revenue growth 3 year average,Deferred Revenue growth 5 year average,Deferred Revenue growth 10 year average,Net Interest Income growth year over year,Net Interest Income growth 3 year average,Net Interest Income growth 5 year average,Net Interest Income growth 10 year average,Free Cash Flow to the Firm growth year over year,Free Cash Flow to the Firm growth 3 year average,Free Cash Flow to the Firm growth 5 year average,Free Cash Flow to the Firm growth 10 year average,Tangible Assets growth year over year,Tangible Assets growth 3 year average,Tangible Assets growth 5 year average,Tangible Assets growth 10 year average,Adjusted Operating Income growth year over year,Adjusted Operating Income growth 3 year average,Adjusted Operating Income growth 5 year average,Adjusted Operating Income growth 10 year average,EBIT growth year over year,EBIT growth 3 year average,EBIT growth 5 year average,EBIT growth 10 year average,Operating Cash Flow growth year over year,Operating Cash Flow growth 3 year average,Operating Cash Flow growth 5 year average,Operating Cash Flow growth 10 year average,Common Book Value growth year over year,Common Book Value growth 3 year average,Common Book Value growth 5 year average,Common Book Value growth 10 year average,Tangible Book Value growth year over year,Tangible Book Value growth 3 year average,Tangible Book Value growth 5 year average,Tangible Book Value growth 10 year average,Common Tangible Book Value growth year over year,Common Tangible Book Value growth 3 year average,Common Tangible Book Value growth 5 year average,Common Tangible Book Value growth 10 year average,Free Cash Flow Ratio growth year over year,Free Cash Flow Ratio growth 3 year average,Free Cash Flow Ratio growth 5 year average,Free Cash Flow Ratio growth 10 year average,"Selling, General and Administrative Exp. Ratio growth year over year","Selling, General and Administrative Exp. Ratio growth 3 year average","Selling, General and Administrative Exp. Ratio growth 5 year average","Selling, General and Administrative Exp. Ratio growth 10 year average",Research and Development Exp. Ratio growth year over year,Research and Development Exp. Ratio growth 3 year average,Research and Development Exp. Ratio growth 5 year average,Research and Development Exp. Ratio growth 10 year average,Other Expenses Ratio growth year over year,Other Expenses Ratio growth 3 year average,Other Expenses Ratio growth 5 year average,Other Expenses Ratio growth 10 year average,Net Interest IncomeRatio growth year over year,Net Interest IncomeRatio growth 3 year average,Net Interest IncomeRatio growth 5 year average,Net Interest IncomeRatio growth 10 year average,Depreciation and Amortization Ratio growth year over year,Depreciation and Amortization Ratio growth 3 year average,Depreciation and Amortization Ratio growth 5 year average,Depreciation and Amortization Ratio growth 10 year average,EBIT Margin growth year over year,EBIT Margin growth 3 year average,EBIT Margin growth 5 year average,EBIT Margin growth 10 year average,Adjusted Operating Margin growth year over year,Adjusted Operating Margin growth 3 year average,Adjusted Operating Margin growth 5 year average,Adjusted Operating Margin growth 10 year average,Operating Cash Flow Margin growth year over year,Operating Cash Flow Margin growth 3 year average,Operating Cash Flow Margin growth 5 year average,Operating Cash Flow Margin growth 10 year average,Cost-to-Income Ratio growth year over year,Cost-to-Income Ratio growth 3 year average,Cost-to-Income Ratio growth 5 year average,Cost-to-Income Ratio growth 10 year average,Operating Expense Ratio growth year over year,Operating Expense Ratio growth 3 year average,Operating Expense Ratio growth 5 year average,Operating Expense Ratio growth 10 year average,Revenue per share growth year over year,Revenue per share growth 3 year average,Revenue per share growth 5 year average,Revenue per share growth 10 year average,Operating Income per share growth year over year,Operating Income per share growth 3 year average,Operating Income per share growth 5 year average,Operating Income per share growth 10 year average,FCF per share growth year over year,FCF per share growth 3 year average,FCF per share growth 5 year average,FCF per share growth 10 year average,CAPEX per share growth year over year,CAPEX per share growth 3 year average,CAPEX per share growth 5 year average,CAPEX per share growth 10 year average,Book value per share growth year over year,Book value per share growth 3 year average,Book value per share growth 5 year average,Book value per share growth 10 year average,Dividends per share growth year over year,Dividends per share growth 3 year average,Dividends per share growth 5 year average,Dividends per share growth 10 year average,Total Debt growth year over year,Total Debt growth 3 year average,Total Debt growth 5 year average,Total Debt growth 10 year average,Financial leverage growth year over year,Financial leverage growth 3 year average,Financial leverage growth 5 year average,Financial leverage growth 10 year average,Cash to Debt Ratio growth year over year,Cash to Debt Ratio growth 3 year average,Cash to Debt Ratio growth 5 year average,Cash to Debt Ratio growth 10 year average,Cash & Investments growth year over year,Cash & Investments growth 3 year average,Cash & Investments growth 5 year average,Cash & Investments growth 10 year average,Cash & Investments to Debt Ratio growth year over year,Cash & Investments to Debt Ratio growth 3 year average,Cash & Investments to Debt Ratio growth 5 year average,Cash & Investments to Debt Ratio growth 10 year average,Net Debt growth year over year,Net Debt growth 3 year average,Net Debt growth 5 year average,Net Debt growth 10 year average,Net Debt w/Investments growth year over year,Net Debt w/Investments growth 3 year average,Net Debt w/Investments growth 5 year average,Net Debt w/Investments growth 10 year average,Working Capital growth year over year,Working Capital growth 3 year average,Working Capital growth 5 year average,Working Capital growth 10 year average,Current Ratio growth year over year,Current Ratio growth 3 year average,Current Ratio growth 5 year average,Current Ratio growth 10 year average,Quick Ratio growth year over year,Quick Ratio growth 3 year average,Quick Ratio growth 5 year average,Quick Ratio growth 10 year average,Cash to Current Assets growth year over year,Cash to Current Assets growth 3 year average,Cash to Current Assets growth 5 year average,Cash to Current Assets growth 10 year average,Cash to Assets growth year over year,Cash to Assets growth 3 year average,Cash to Assets growth 5 year average,Cash to Assets growth 10 year average,Debt to Equity growth year over year,Debt to Equity growth 3 year average,Debt to Equity growth 5 year average,Debt to Equity growth 10 year average,Debt to Assets growth year over year,Debt to Assets growth 3 year average,Debt to Assets growth 5 year average,Debt to Assets growth 10 year average,Interest Coverage growth year over year,Interest Coverage growth 3 year average,Interest Coverage growth 5 year average,Interest Coverage growth 10 year average,Current Liability Coverage Ratio growth year over year,Current Liability Coverage Ratio growth 3 year average,Current Liability Coverage Ratio growth 5 year average,Current Liability Coverage Ratio growth 10 year average,Cash Ratio growth year over year,Cash Ratio growth 3 year average,Cash Ratio growth 5 year average,Cash Ratio growth 10 year average,Net Working Capital to Assets growth year over year,Net Working Capital to Assets growth 3 year average,Net Working Capital to Assets growth 5 year average,Net Working Capital to Assets growth 10 year average,Long Term Debt Ratio growth year over year,Long Term Debt Ratio growth 3 year average,Long Term Debt Ratio growth 5 year average,Long Term Debt Ratio growth 10 year average,Total Debt/ Assets growth year over year,Total Debt/ Assets growth 3 year average,Total Debt/ Assets growth 5 year average,Total Debt/ Assets growth 10 year average,Net Debt/ Assets growth year over year,Net Debt/ Assets growth 3 year average,Net Debt/ Assets growth 5 year average,Net Debt/ Assets growth 10 year average,Total Debt/ Equity growth year over year,Total Debt/ Equity growth 3 year average,Total Debt/ Equity growth 5 year average,Total Debt/ Equity growth 10 year average,Total Liabilities/ Equity growth year over year,Total Liabilities/ Equity growth 3 year average,Total Liabilities/ Equity growth 5 year average,Total Liabilities/ Equity growth 10 year average,Net Debt/ Equity growth year over year,Net Debt/ Equity growth 3 year average,Net Debt/ Equity growth 5 year average,Net Debt/ Equity growth 10 year average,Equity Ratio growth year over year,Equity Ratio growth 3 year average,Equity Ratio growth 5 year average,Equity Ratio growth 10 year average,Equity Multiplier growth year over year,Equity Multiplier growth 3 year average,Equity Multiplier growth 5 year average,Equity Multiplier growth 10 year average,Debt/ Tangible Book Value growth year over year,Debt/ Tangible Book Value growth 3 year average,Debt/ Tangible Book Value growth 5 year average,Debt/ Tangible Book Value growth 10 year average,Net Debt/ EBITDA growth year over year,Net Debt/ EBITDA growth 3 year average,Net Debt/ EBITDA growth 5 year average,Net Debt/ EBITDA growth 10 year average,Cash to Debt growth year over year,Cash to Debt growth 3 year average,Cash to Debt growth 5 year average,Cash to Debt growth 10 year average,Cash Flow Coverage Ratio growth year over year,Cash Flow Coverage Ratio growth 3 year average,Cash Flow Coverage Ratio growth 5 year average,Cash Flow Coverage Ratio growth 10 year average,Free Cash Flow/ Long Term Debt growth year over year,Free Cash Flow/ Long Term Debt growth 3 year average,Free Cash Flow/ Long Term Debt growth 5 year average,Free Cash Flow/ Long Term Debt growth 10 year average,Debt Leverage Ratio growth year over year,Debt Leverage Ratio growth 3 year average,Debt Leverage Ratio growth 5 year average,Debt Leverage Ratio growth 10 year average,Interest Expense to Debt Ratio growth year over year,Interest Expense to Debt Ratio growth 3 year average,Interest Expense to Debt Ratio growth 5 year average,Interest Expense to Debt Ratio growth 10 year average,Cash Sales growth year over year,Cash Sales growth 3 year average,Cash Sales growth 5 year average,Cash Sales growth 10 year average,Cash Revenue Adjustment growth year over year,Cash Revenue Adjustment growth 3 year average,Cash Revenue Adjustment growth 5 year average,Cash Revenue Adjustment growth 10 year average,CFO/ Net Income growth year over year,CFO/ Net Income growth 3 year average,CFO/ Net Income growth 5 year average,CFO/ Net Income growth 10 year average,Return on Equity growth year over year,Return on Equity growth 3 year average,Return on Equity growth 5 year average,Return on Equity growth 10 year average,NOPAT growth year over year,NOPAT growth 3 year average,NOPAT growth 5 year average,NOPAT growth 10 year average,Invested Capital growth year over year,Invested Capital growth 3 year average,Invested Capital growth 5 year average,Invested Capital growth 10 year average,Return on Invested Capital growth year over year,Return on Invested Capital growth 3 year average,Return on Invested Capital growth 5 year average,Return on Invested Capital growth 10 year average,Capital Employed growth year over year,Capital Employed growth 3 year average,Capital Employed growth 5 year average,Capital Employed growth 10 year average,ROCE growth year over year,ROCE growth 3 year average,ROCE growth 5 year average,ROCE growth 10 year average,CFROI growth year over year,CFROI growth 3 year average,CFROI growth 5 year average,CFROI growth 10 year average,Asset Turnover Ratio growth year over year,Asset Turnover Ratio growth 3 year average,Asset Turnover Ratio growth 5 year average,Asset Turnover Ratio growth 10 year average,Inventory Turnover growth year over year,Inventory Turnover growth 3 year average,Inventory Turnover growth 5 year average,Inventory Turnover growth 10 year average,Receivables Turnover growth year over year,Receivables Turnover growth 3 year average,Receivables Turnover growth 5 year average,Receivables Turnover growth 10 year average,Cash Turnover Ratio growth year over year,Cash Turnover Ratio growth 3 year average,Cash Turnover Ratio growth 5 year average,Cash Turnover Ratio growth 10 year average,Gross Profitability Ratio growth year over year,Gross Profitability Ratio growth 3 year average,Gross Profitability Ratio growth 5 year average,Gross Profitability Ratio growth 10 year average,Tangible Gross Profitability Ratio growth year over year,Tangible Gross Profitability Ratio growth 3 year average,Tangible Gross Profitability Ratio growth 5 year average,Tangible Gross Profitability Ratio growth 10 year average,Cash Return on Invested Capital growth year over year,Cash Return on Invested Capital growth 3 year average,Cash Return on Invested Capital growth 5 year average,Cash Return on Invested Capital growth 10 year average,Adjusted Return on Capital Employed growth year over year,Adjusted Return on Capital Employed growth 3 year average,Adjusted Return on Capital Employed growth 5 year average,Adjusted Return on Capital Employed growth 10 year average,Cash Return on Capital Employed growth year over year,Cash Return on Capital Employed growth 3 year average,Cash Return on Capital Employed growth 5 year average,Cash Return on Capital Employed growth 10 year average,EBIT Return on Assets growth year over year,EBIT Return on Assets growth 3 year average,EBIT Return on Assets growth 5 year average,EBIT Return on Assets growth 10 year average,EBIT Return on Tangible Assets growth year over year,EBIT Return on Tangible Assets growth 3 year average,EBIT Return on Tangible Assets growth 5 year average,EBIT Return on Tangible Assets growth 10 year average,Return on Assets growth year over year,Return on Assets growth 3 year average,Return on Assets growth 5 year average,Return on Assets growth 10 year average,Return on Tangible Equity growth year over year,Return on Tangible Equity growth 3 year average,Return on Tangible Equity growth 5 year average,Return on Tangible Equity growth 10 year average,Cash Return on Equity growth year over year,Cash Return on Equity growth 3 year average,Cash Return on Equity growth 5 year average,Cash Return on Equity growth 10 year average,Return on Retained Earnings growth year over year,Return on Retained Earnings growth 3 year average,Return on Retained Earnings growth 5 year average,Return on Retained Earnings growth 10 year average,R&D / Assets growth year over year,R&D / Assets growth 3 year average,R&D / Assets growth 5 year average,R&D / Assets growth 10 year average,R&D / Book growth year over year,R&D / Book growth 3 year average,R&D / Book growth 5 year average,R&D / Book growth 10 year average,CapEx / Assets growth year over year,CapEx / Assets growth 3 year average,CapEx / Assets growth 5 year average,CapEx / Assets growth 10 year average,CapEx / Fixed Assets growth year over year,CapEx / Fixed Assets growth 3 year average,CapEx / Fixed Assets growth 5 year average,CapEx / Fixed Assets growth 10 year average,Retained Earnings / Total Assets growth year over year,Retained Earnings / Total Assets growth 3 year average,Retained Earnings / Total Assets growth 5 year average,Retained Earnings / Total Assets growth 10 year average,Inventory / Assets growth year over year,Inventory / Assets growth 3 year average,Inventory / Assets growth 5 year average,Inventory / Assets growth 10 year average,Accounts Receivable / Assets growth year over year,Accounts Receivable / Assets growth 3 year average,Accounts Receivable / Assets growth 5 year average,Accounts Receivable / Assets growth 10 year average,Plowback Ratio growth year over year,Plowback Ratio growth 3 year average,Plowback Ratio growth 5 year average,Plowback Ratio growth 10 year average,Dividend & Repurchase / FCF growth year over year,Dividend & Repurchase / FCF growth 3 year average,Dividend & Repurchase / FCF growth 5 year average,Dividend & Repurchase / FCF growth 10 year average,Dividend & Repurchase / EBITDA growth year over year,Dividend & Repurchase / EBITDA growth 3 year average,Dividend & Repurchase / EBITDA growth 5 year average,Dividend & Repurchase / EBITDA growth 10 year average
2003,3403703,-498743.0,3902446.0,1.1465295297503924,0.0,498743.0,0.0,498743.0,0.0,0.0,0.0,0.0,2370424.0,0.6964,3403703,1.0,-1033279,2370424,0.6964,917076,1453348,0.427,1.98,1.98,734183,734183,0.0,14992901.0,14992901.0,,,,,,0.0,0.0,0.0,0.0,0.0,,,17154506.0,17154506.0,,0.0,0.0,,,,0.0,,0.0,0.0,,9695550.0,0.0,9695550.0,0.0,2092300.0,4450980.0,0.0,915676.0,7458956.0,17154506.0,0.0,17154506.0,1453348,,0.0,0.0,,-9172871,0.0,9496397,0.0,-4417496,-2964148,0.0,0.0,0.0,0.0,1974470.0,1974470.0,0.0,0.0,0.0,-367091.0,0.0,-367091.0,0.0,-1356769,123502,1480271,-2964148,24.05,24.05,23.62,1500.0,0.0,0.0,23.62,0.3868826842792682,,0.0,-2964148.0,17154506.0,3403703.0,2370424.0,,7458956.0,7458956.0,7458956.0,-0.8708597665542499,0.12780266530273576,0.0,0.0,0.0,0.0,0.6964250406101825,1.0,,0.14652952975039243,0.14652952975039243,4.636041695326642,4.636041695326642,-4.037342188527928,0.0,10.159532432649625,-0.4999993189708833,0.0,0.0,,14992901.0,99.0,-14992901.0,-14992901.0,,,,,0.8739919995364483,,,99.0,,,,,0.0,-0.8739919995364483,0.0,1.2998534915610174,-2.0100535517302958,0.43481030581702557,2.2998534915610174,1.2998534915610174,-6.324987006543977,inf,,-inf,4.090217615076459,,12576574,,,0.19484603475338907,2086869.246870602,17154506.0,0.12165137526377047,,,,0.19841451569634241,,-0.3710619063540739,inf,0.2274881013769793,0.2274881013769793,-0.1727912188202913,,,0.13818083715147494,0.13818083715147494,0.12165137526377047,0.19484603475338907,,0.32652314771129054,0.0,0.0,-0.0,,0.2594641897586558,,-0.5347207899778635,1.2525830014559487,0.12384368121969619,-0.1548630118493569,,,,,,,,,,,,,,,,,,,,,,,,,,,,,,,,,,,,,,,,,,,,,,,,,,,,,,,,,,,,,,,,,,,,,,,,,,,,,,,,,,,,,,,,,,,,,,,,,,,,,,,,,,,,,,,,,,,,,,,,,,,,,,,,,,,,,,,,,,,,,,,,,,,,,,,,,,,,,,,,,,,,,,,,,,,,,,,,,,,,,,,,,,,,,,,,,,,,,,,,,,,,,,,,,,,,,,,,,,,,,,,,,,,,,,,,,,,,,,,,,,,,,,,,,,,,,,,,,,,,,,,,,,,,,,,,,,,,,,,,,,,,,,,,,,,,,,,,,,,,,,,,,,,,,,,,,,,,,,,,,,,,,,,,,,,,,,,,,,,,,,,,,,,,,,,,,,,,,,,,,,,,,,,,,,,,,,,,,,,,,,,,,,,,,,,,,,,,,,,,,,,,,,,,,,,,,,,,,,,,,,,,,,,,,,,,,,,,,,,,,,,,,,,,,,,,,,,,,,,,,,,,,,,,,,,,,,,,,,,,,,,,,,,,,,,,,,,,,,,,,,,,,,,,,,,,,,,,,,,,,,,,,,,,,,,,,,,,,,,,,,,,,,,,,,,,,,,,,,,,,,,,,,,,,,,,,,,,,,,,,,,,,,,,,,,,,,,,,,,,,,,,,,,,,,,,,,,,,,,,,,,,,,,,,,,,,,,,,,,,,,,,,,,,,,,,,,,,,,,,,,,,,,,,,,,,,,,,,,,,,,,,,,,,,,,,,,,,,,,,,,,,,,,,,,,,,,,,,,,,,,,,,,,,,,,,,,,,,,,,,,,,,,,,,,,,,,,,,,,,,,,,,,,,,,,,,,,,,,,,,,,,,,,,
2004,6844000,-472000.0,7316000.0,1.0689655172413792,0.0,472000.0,0.0,472000.0,0.0,0.0,0.0,0.0,5551000.0,0.8111,6844000,1.0,-1293000,5551000,0.8111,2324000,3227000,0.4715,4.4,4.4,734183,734183,0.0,19451000.0,19451000.0,,,,,,0.0,0.0,0.0,0.0,0.0,,,23315000.0,23315000.0,,0.0,0.0,,,,0.0,,0.0,0.0,,13180000.0,0.0,13180000.0,0.0,2092000.0,7127000.0,0.0,916000.0,10135000.0,23315000.0,0.0,23315000.0,3227000,,0.0,0.0,,-2875000,0.0,3484000,0.0,-3641000,-414000,0.0,0.0,0.0,0.0,953000.0,953000.0,0.0,0.0,0.0,-551000.0,0.0,-551000.0,0.0,-12000,112000,124000,-414000,24.55,24.35,24.15,1800.0,0.25,0.25,24.4,0.41866330390920553,,0.0,-414000.0,23315000.0,6844000.0,5551000.0,,10135000.0,10135000.0,10135000.0,-0.06049094097019287,0.06451612903225806,0.0,0.0,0.0,0.0,0.8110753945061367,1.0,,0.06896551724137931,0.06896551724137931,9.321926549647703,9.321926549647703,-0.5638921086432129,0.0,13.804460195891215,-0.7504940866241795,0.0,0.0,,19451000.0,99.0,-19451000.0,-19451000.0,,,,,0.8342697834012438,,,99.0,,,,,0.0,-0.8342697834012438,0.0,1.300444005920079,-1.9191909225456338,0.43469869182929444,2.300444005920079,1.300444005920079,-3.5040533237254547,inf,,-inf,2.3743469645108988,,9719000,,,0.31840157868771585,3978668.348045397,23315000.0,0.17064843868948734,,,,0.2935449281578383,,-2.380521739130435,inf,0.31378940596182714,0.31378940596182714,-0.017756808921295303,,,0.23808706841089428,0.23808706841089428,0.17064843868948734,0.31840157868771585,,0.4527851831064964,0.0,0.0,-0.0,,0.30568303667167057,,-0.12331117306455072,1.17074682367524,1.3309178743961352,-0.09926139434336155,1.0107512318201675,,,,-0.05362080269798275,,,,0.8747216489350524,,,,-0.06765112497878656,,,,,,,,-0.05362080269798275,,,,,,,,-0.05362080269798275,,,,,,,,,,,,,,,,,,,,1.3417751423374047,,,,0.16470419299253303,,,,1.0107512318201675,,,,0.0,,,,0.2513561196927452,,,,1.3417751423374047,,,,0.16470419299253303,,,,1.534141118075274,,,,1.2203904364267886,,,,0.10421545667447307,,,,1.2222222222222223,,,,1.2222222222222223,,,,0.0,,,,0.0,,,,,,,,0.29734732457714497,,,,0.29734732457714497,,,,,,,,,,,,,,,,,,,,,,,,,,,,,,,,,,,,,,,,,,,,,,,,,,,,0.35911812324994963,,,,0.35911812324994963,,,,,,,,,,,,,,,,,,,,,,,,,,,,,,,,,,,,,,,,,,,,,,,,0.3593865226830866,,,,,,,,0.3593865226830866,,,,,,,,-0.0001433828800840864,,,,0.6012204053938683,,,,,,,,0.000353836946692887,,,,0.35876924330965343,,,,0.35911812324994963,,,,,,,,0.35911812324994963,,,,1.2203904364267886,,,,,,,,,,,,,,,,,,,,-0.6865757732775267,,,,,,,,-0.6331240153502429,,,,,,,,-0.17577740874015502,,,,-0.8603308606722742,,,,,,,,,,,,,,,,,,,,-0.5173388301670828,,,,-0.5173388301670828,,,,,,,,,,,,,,,,0.5009902176844434,,,,,,,,0.5009902176844434,,,,,,,,-0.9911554582983544,,,,-0.0931320950268012,,,,-0.916231554897718,,,,-0.8603308606722742,,,,0.02079002079002068,,,,0.012474012474012586,,,,0.02243861134631664,,,,0.19999999999999996,,,,inf,,,,inf,,,,0.03302286198137172,,,,0.0821453658210165,,,,,,,,,,,,-0.8603308606722742,,,,0.35911812324994963,,,,1.0107512318201675,,,,1.3417751423374047,,,,,,,,0.35876924330965343,,,,0.35876924330965343,,,,0.35876924330965343,,,,-0.9305388269232615,,,,-0.49518948701551824,,,,,,,,,,,,,,,,,,,,0.16462698382513885,,,,0.0,,,,,,,,-0.5293404861200368,,,,-0.5293404861200368,,,,1.0107512318201675,,,,1.0107512318201675,,,,-0.8603308606722742,,,,,,,,0.35876924330965365,,,,0.5009902176844432,,,,,,,,,,,,,,,,0.29734732457714497,,,,0.0,,,,0.29734732457714497,,,,0.29734732457714497,,,,,,,,,,,,,,,,,,,,-0.045449175914965556,,,,,,,,,,,,0.0,,,,,,,,,,,,,,,,,,,,,,,,-0.045449175914965556,,,,,,,,0.0004542930129398659,,,,-0.04520408379490459,,,,-0.00025669581939047337,,,,0.00025676172905275685,,,,0.0004542930129398659,,,,-0.44599833642344555,,,,,,,,,,,,,,,,-0.419505955927845,,,,,,,,-0.22721402505960686,,,,,,,,,,,,0.634118852306681,,,,0.9065249794694481,,,,0.35911812324994963,,,,0.40276621057081385,,,,,,,,,,,,,,,,0.4794528874444115,,,,,,,,5.4154301435052155,,,,,,,,0.37936623525568325,,,,0.37936623525568325,,,,-0.8972354669263432,,,,,,,,,,,,0.723010754015778,,,,0.723010754015778,,,,0.40276621057081385,,,,0.634118852306681,,,,,,,,0.3866863230990467,,,,,,,,,,,,,,,,,,,,0.17813189155700382,,,,,,,,-0.7693914742502239,,,,-0.06533393610290561,,,,9.746756405238905,,,,-0.35903742825357077,,,
2005,405000,-4357000.0,4762000.0,11.758024691358024,0.0,441000.0,0.0,441000.0,-3916000.0,0.0,0.0,0.0,-4302000.0,-10.6222,4321000,10.6691,-8623000,-4302000,-10.6222,-1779000,-2523000,-6.2296,-3.44,-3.44,734183,734183,0.0,8889000.0,8889000.0,,,,,,0.0,0.0,0.0,0.0,0.0,,,10930000.0,10930000.0,,0.0,0.0,,,,0.0,,0.0,0.0,,3800000.0,0.0,3800000.0,0.0,2092000.0,4122000.0,0.0,916000.0,7130000.0,10930000.0,0.0,10930000.0,-2523000,,0.0,0.0,,7818000,0.0,-9862000,0.0,2431000,-92000,,0.0,0.0,0.0,0.0,,0.0,0.0,0.0,0.0,,,0.0,-92000,20000,112000,-92000,34.55,35.0,34.71,2000.0,0.0,0.25,34.96,0.41352859135285913,,0.0,-92000.0,10930000.0,4321000.0,-4302000.0,,7130000.0,7130000.0,7130000.0,-0.2271604938271605,0.09260814783704326,0.0,0.0,0.0,0.0,-10.622222222222222,10.669135802469135,,0.10205970840083314,1.0888888888888888,0.5516335845422735,5.885453626684355,-0.12530935747626953,,9.71147520441089,0.0,0.0,0.0,,8889000.0,99.0,-8889000.0,-8889000.0,,,,,0.8132662397072278,,,-inf,,,,,0.0,-0.8132662397072278,0.0,0.5329593267882188,-1.2467040673211782,0.6523330283623056,1.532959326788219,0.5329593267882188,2.0662482566248257,inf,,-inf,-0.8833100883310089,,-7413000,,,-0.3538569424964937,2534142.9567642957,10930000.0,0.23185205459874617,,,,0.03705397987191217,,0.05180353031465848,inf,0.4356816102470265,0.4356816102470265,-0.008417200365965233,,,-0.39359560841720037,-0.39359560841720037,0.23185205459874617,-0.3538569424964937,,-0.6120815138282387,0.0,0.0,,,0.37712717291857273,,0.7152790484903934,1.0,-0.0,-0.0,-0.9408240794856809,,,,8.23093220338983,,,,-0.3490978676872608,,,,9.999442453205894,,,,,,,,-0.06567796610169496,,,,,,,,-0.06567796610169496,,,,-inf,,,,,,,,,,,,,,,,-1.7749954963069716,,,,-14.096042411539882,,,,-0.3686440677966102,,,,9.6691,,,,5.668986852281516,,,,-1.7749954963069716,,,,-14.096042411539882,,,,-1.7654905335628226,,,,-1.7818407189339944,,,,-14.212301166489926,,,,-1.7818181818181817,,,,-1.7818181818181817,,,,0.0,,,,0.0,,,,,,,,-0.5430055010025192,,,,-0.5430055010025192,,,,,,,,,,,,,,,,,,,,,,,,,,,,,,,,,,,,,,,,,,,,,,,,,,,,-0.531203088140682,,,,-0.531203088140682,,,,,,,,,,,,,,,,,,,,,,,,,,,,,,,,,,,,,,,,,,,,,,,,-0.7116843702579666,,,,,,,,-0.7116843702579666,,,,,,,,0.0,,,,-0.42163603199102007,,,,,,,,0.0,,,,-0.29649728663048835,,,,-0.531203088140682,,,,,,,,-0.531203088140682,,,,-1.7818407189339944,,,,,,,,,,,,,,,,,,,,-3.7193043478260868,,,,,,,,-3.830654420206659,,,,,,,,-1.6676737160120845,,,,-0.7777777777777778,,,,,,,,,,,,,,,,,,,,-1.0,,,,,,,,,,,,,,,,,,,,-1.0,,,,,,,,,,,,,,,,6.666666666666667,,,,-0.8214285714285714,,,,-0.09677419354838712,,,,-0.7777777777777778,,,,0.40733197556008127,,,,0.43737166324435317,,,,0.4372670807453418,,,,0.11111111111111116,,,,-1.0,,,,0.0,,,,0.4327868852459018,,,,-0.01226453932886351,,,,,,,,,,,,-0.7777777777777778,,,,-0.531203088140682,,,,-0.3686440677966102,,,,-1.7749954963069716,,,,,,,,-0.29649728663048835,,,,-0.29649728663048835,,,,-0.29649728663048835,,,,2.755281207133059,,,,0.43542629147417045,,,,,,,,,,,,,,,,,,,,-14.09646710302448,,,,9.669135802469135,,,,,,,,0.4798657718120807,,,,14.788888888888888,,,,-0.9408240794856809,,,,-0.3686440677966101,,,,-0.7777777777777778,,,,,,,,-0.29649728663048835,,,,-1.0,,,,,,,,,,,,,,,,-0.5430055010025192,,,,0.0,,,,-0.5430055010025192,,,,-0.5430055010025192,,,,,,,,,,,,,,,,,,,,-0.02517596119613308,,,,,,,,,,,,-inf,,,,,,,,,,,,,,,,,,,,,,,,-0.02517596119613308,,,,,,,,-0.5901712612292416,,,,-0.3504012275821221,,,,0.5006556049597586,,,,-0.33362458601764533,,,,-0.5901712612292416,,,,-1.5896737480090692,,,,,,,,,,,,,,,,-1.3720223293114895,,,,,,,,-1.7627327914394484,,,,,,,,,,,,-2.111354233716134,,,,-0.3630675555027738,,,,-0.531203088140682,,,,0.3586532427678708,,,,,,,,,,,,,,,,-0.8737706690950274,,,,,,,,-1.0217614187104973,,,,,,,,0.38845226119593,,,,0.38845226119593,,,,-0.5259733658635763,,,,,,,,,,,,-2.6531582796337645,,,,-2.6531582796337645,,,,0.3586532427678708,,,,-2.111354233716134,,,,,,,,-2.3518143628924255,,,,,,,,,,,,,,,,,,,,0.23371966277487366,,,,,,,,-6.800602092366442,,,,-0.1458443620963472,,,,-1.0,,,,-1.0,,,
2006,1931000,-4841000.0,6772000.0,3.506991196271362,0.0,566000.0,0.0,566000.0,-4275000.0,0.0,0.0,0.0,-3307000.0,-1.7126,6206000,3.2139,-9513000,-3307000,-1.7126,-1704000,-1603000,-0.8301,-2.18,-2.18,734183,734183,0.0,13743000.0,13743000.0,,,,,,0.0,0.0,0.0,0.0,0.0,,,15317000.0,15317000.0,,0.0,0.0,,,,0.0,,0.0,0.0,,9790000.0,0.0,9790000.0,0.0,0.0,2519000.0,0.0,3008000.0,5527000.0,15317000.0,0.0,15317000.0,-1603000,,0.0,0.0,,-4875000,0.0,3802000,0.0,1871000,268000,0.0,0.0,-180000.0,0.0,0.0,-180000.0,0.0,0.0,0.0,0.0,,,0.0,88000,108000,20000,268000,34.665,34.75,34.46,500.0,0.0,0.25,34.71,0.5152706380405201,,0.0,268000.0,15317000.0,6206000.0,-3307000.0,,5527000.0,5527000.0,5527000.0,0.13878819264629724,0.08357944477259303,0.0,0.0,0.0,0.0,-1.7125841532884516,3.2138788192646297,,0.0912020625201418,0.29311237700673226,2.6301344487682226,8.452933396714442,0.3650316065613069,0.0,7.5280958562102365,0.0,0.0,0.0,,13743000.0,99.0,-13743000.0,-13743000.0,,,,,0.897238362603643,,,-inf,,,,,0.0,-0.897238362603643,0.0,1.7713045051565044,-2.486520716482721,0.3608408957367631,2.7713045051565044,1.7713045051565044,4.155730269126096,inf,,inf,-2.9603870577562748,,6806000,,,-0.2900307580966166,3008230.4203205323,15317000.0,0.1963981471776805,,,,0.12606907357837696,,-0.3961025641025641,inf,0.4421231311614546,0.4421231311614546,0.017496898870536005,,,-0.21590389763008422,-0.21590389763008422,0.1963981471776805,-0.2900307580966166,,-0.6363636363636364,0.0,0.0,-0.0,,0.16445779199582164,,-0.31827381340993666,1.0,0.0,-0.0,3.7679012345679013,1.2792761289674626,,,0.11108560936424139,2.7627990033520295,,,0.4220915581688367,0.3159051131388761,,,-0.70173636402984,3.076684988065756,,,,,,,0.28344671201814053,0.05471598107282094,,,,,,,0.28344671201814053,0.05471598107282094,,,0.09167517875383036,,,,,,,,,,,,,,,,-0.23128777312877735,-0.22150270903278146,,,-0.8387716292293499,-4.9233699492589,,,0.43624161073825496,0.3594495915872707,,,-0.6987655940988462,2.990111468633718,,,0.103212339093123,2.0078517703557948,,,-0.23128777312877735,-0.22150270903278146,,,-0.8387716292293499,-4.9233699492589,,,-0.042158516020236125,-0.09116931050259487,,,-0.36464526357510896,-0.3086985153607717,,,-0.866749068961089,-4.991611592925515,,,-0.36627906976744184,-0.30862500978780033,,,-0.36627906976744184,-0.30862500978780033,,,0.0,0.0,,,0.0,0.0,,,,,,,0.546068174147823,0.10013666590748294,,,0.546068174147823,0.10013666590748294,,,,,,,,,,,,,,,,,,,,,,,,,,,,,,,,,,,,,,,,,,,,,,,,,,,0.40137236962488565,0.07642913491138444,,,0.40137236962488565,0.07642913491138444,,,,,,,,,,,,,,,,,,,,,,,,,,,,,,,,,,,,,,,,,,,,,,,1.5763157894736843,0.40800598063293475,,,,,,,1.5763157894736843,0.40800598063293475,,,,,,,-1.0,-0.3333811276266947,,,-0.38888888888888884,-0.06976817182868018,,,,,,,2.2838427947598254,0.7613988772355061,,,-0.22482468443197756,-0.05418424258427083,,,0.40137236962488565,0.07642913491138444,,,,,,,0.40137236962488565,0.07642913491138444,,,-0.36464526357510896,-0.3086985153607717,,,,,,,,,,,,,,,,,,,-1.623561013046815,-2.0098137113834764,,,,,,,-1.3855201784627864,-1.9497662046732291,,,,,,,-0.230357877416701,-0.6912696673896468,,,-3.9130434782608696,-1.8503840389036406,,,,,,,,,,,-inf,,,,,,,,,,,,,,,,,,,,,,,,,,,,,,,,,,,,,,,,,,,,-1.9565217391304348,1.239663156412626,,,4.4,1.1618131111815426,,,-0.8214285714285714,-0.6114781066248921,,,-3.9130434782608696,-1.8503840389036406,,,0.0033285094066570764,0.143816835252253,,,-0.0071428571428571175,0.1475676061918362,,,-0.007202535292422985,0.15083438559974516,,,-0.75,-0.14629629629629629,,,,,,,0.0,inf,,,-0.007151029748283744,0.15288623915966326,,,0.24603388693103856,0.10530490447439718,,,,,,,,,,,-3.9130434782608696,-1.8503840389036406,,,0.40137236962488565,0.07642913491138444,,,0.43624161073825496,0.3594495915872707,,,-0.23128777312877735,-0.22150270903278146,,,,,,,-0.22482468443197756,-0.05418424258427083,,,-0.22482468443197756,-0.05418424258427083,,,-0.22482468443197756,-0.05418424258427083,,,-1.6109697611059826,0.07125753970127158,,,-0.09749361449639904,-0.05241893667924894,,,,,,,,,,,,,,,,,,,-0.8387734583724261,-4.923537859190589,,,-0.6987685901869533,2.990122404094061,,,,,,,-0.10638523322101423,-0.05195331584299012,,,-0.7308151639734091,4.509577746265148,,,3.7679012345679013,1.2792761289674626,,,0.43624161073825496,0.3594495915872708,,,-3.9130434782608696,-1.8503840389036406,,,,,,,-0.22482468443197756,-0.05418424258427076,,,,,,,,,,,,,,,,,,,0.546068174147823,0.10013666590748294,,,0.0,0.0,,,0.546068174147823,0.10013666590748294,,,0.546068174147823,0.10013666590748294,,,,,,,,,,,,,,,,,,,0.10325293095486754,0.010875931281256301,,,,,,,,,,,,,,,,,,,,,,,,,,,,,,,,,,,0.10325293095486754,0.010875931281256301,,,,,,,2.32352661099102,0.5779365475915729,,,0.994475498764968,0.19962339579598043,,,-0.44684558339371383,0.017851108582218094,,,0.8078134603628431,0.1581485453580835,,,2.32352661099102,0.5779365475915729,,,1.0112444164450967,-0.34147588932913936,,,,,,,,,,,,,,,2.351469769070393,0.1866471612770195,,,,,,,-1.9181168217995412,-1.3026878794328656,,,,,,,,,,,-0.1803728477095219,-0.5525360763729916,,,0.1870799996861945,0.24351247455095626,,,0.40137236962488565,0.07642913491138444,,,-0.15291608039628468,0.20283445764746666,,,,,,,,,,,,,,,2.4023085783003957,0.6693302655499266,,,,,,,-8.6462465337132,-1.4175259363061603,,,,,,,0.014784927256341618,0.2608678079026516,,,0.014784927256341618,0.2608678079026516,,,-3.0787076592930274,-1.5006388306943155,,,,,,,,,,,-0.4514575543707995,-0.7938683599962619,,,-0.4514575543707995,-0.7938683599962619,,,-0.15291608039628468,0.20283445764746666,,,-0.1803728477095219,-0.5525360763729916,,,,,,,0.03967138687709437,-0.6418188843054282,,,,,,,,,,,,,,,,,,,-0.5639195374783283,-0.05068932771548362,,,,,,,-1.4449645408762608,-3.0049860358309757,,,0.0,-0.0703927660664176,,,,,,,,,,
2007,33185000,0.0,33185000.0,1.0,0.0,0.0,-34057000.0,-34057000.0,-34057000.0,0.0,0.0,4172000.0,1648000.0,0.0497,67242000,2.0263,-69766000,-2524000,-0.0761,-1029000,-1495000,-0.0451,-2.04,-2.04,734183,734183,0.0,53229000.0,53229000.0,,,,,,0.0,0.0,0.0,0.0,0.0,,,65418000.0,65418000.0,,0.0,0.0,,,,0.0,,0.0,0.0,,61386000.0,0.0,61386000.0,0.0,0.0,1024000.0,0.0,3008000.0,4032000.0,65418000.0,0.0,65418000.0,-1495000,4172000.0,0.0,0.0,,1174000,0.0,67000,0.0,-2435000,242000,-2355000.0,0.0,0.0,0.0,-1500000.0,-3855000.0,-16551000.0,0.0,0.0,0.0,18500000.0,1949000.0,0.0,-1664000,796000,2460000,-2113000,35.004999999999995,34.75,34.46,500.0,0.0,0.25,34.71,0.40768621236133123,,0.0,-2113000.0,65418000.0,29013000.0,-2524000.0,,4032000.0,4032000.0,4032000.0,-0.06367334639144191,0.0,0.0,-1.026276932348953,0.0,0.1257194515594395,-0.07605846014765708,0.8742805484405605,,-0.5064840427114006,-1.026276932348953,45.199902476630484,91.58751973281866,-2.8780290472538863,-3.207647139745813,5.491818797220857,0.0,0.0,0.0,,53229000.0,99.0,-53229000.0,-53229000.0,,,,,0.8136751352838668,,,-inf,,,,,0.0,-0.8136751352838668,0.0,15.224702380952381,-13.201636904761905,0.06163441254700541,16.22470238095238,15.224702380952381,-32.29915048543689,inf,,-inf,37.24878640776699,,32011000,,,-0.3707837301587302,39828363.70839937,65418000.0,0.6088288194136074,,,,0.507276284814577,,28.266609880749574,inf,0.507276284814577,0.507276284814577,-0.03229997859916231,,,-0.038582653092421045,-0.038582653092421045,0.6088288194136074,-0.3707837301587302,,-1.4599609375,0.0,0.0,0.03599926625699349,,0.01565318413892201,,0.017946131034271912,1.0,-0.0,0.0,16.18539616778871,6.337491107623644,,,-1.0,2.447339270918024,,,3.9003248670998225,1.3244395191937994,,,-0.7148552864737153,2.8609502675674463,,,,,,,-1.0,-0.26074375136118483,,,-inf,,,,-61.17137809187279,-20.317869781985447,,,6.966549707602339,-inf,,,,,,,,,,,inf,,,,-1.4983368612035077,-1.1682067102130855,,,-1.0290202031998132,-5.3212780813230145,,,9.834998388656139,3.3008653105325947,,,-0.36951989794330875,2.866938169319282,,,6.333753810575002,4.035317667316547,,,-0.23677048684608404,-0.7476845854272777,,,-0.9555646385612518,-5.296792893110161,,,-0.39612676056338025,-0.7345919367154797,,,-0.06737367436057395,-0.7379532189565591,,,-0.9456691964823515,-5.341573143977789,,,-0.06422018348623859,-0.737439145023954,,,-0.06422018348623859,-0.737439145023954,,,0.0,0.0,,,0.0,0.0,,,,,,,2.8731717965509715,0.9587448232320916,,,2.8731717965509715,0.9587448232320916,,,,,,,,,,,,,,,,,,,,,,,,,,,,,,,,,,,,,,,,,,,,,,,,,,,3.270940784748972,1.0470366887443918,,,3.270940784748972,1.0470366887443918,,,,,,,,,,,,,,,,,,,,,,,,,,,,,,,,,,,,,,,,,,,,,,,5.2702757916241065,2.0449690702799415,,,,,,,5.2702757916241065,2.0449690702799415,,,,,,,,,,,-0.593489479952362,-0.4680048002774237,,,,,,,0.0,0.7612809315866085,,,-0.2704903202460648,-0.2639374304361769,,,3.270940784748972,1.0470366887443918,,,,,,,3.270940784748972,1.0470366887443918,,,-0.06737367436057395,-0.7379532189565591,,,,,,,,,,,,,,,,,,,-1.2408205128205128,-2.194561957897805,,,,,,,-0.9823776959495003,-2.0661840982063153,,,,,,,-2.301443078567611,-1.3998248906654656,,,-0.09701492537313428,-1.595945393803927,,,-inf,,,,,,,,-1.0,,,,,,,,-inf,,,,20.416666666666668,,,,-inf,,,,,,,,,,,,,,,,,,,,,,,,,,,,-19.90909090909091,-5.066315327184892,,,6.37037037037037,3.3163139329806,,,122.0,40.36059907834102,,,-8.884328358208954,-4.525049871415868,,,0.009808163854031271,0.14015621627358987,,,0.0,0.14340960203383202,,,0.0,0.14335484848430627,,,0.0,-0.21296296296296294,,,,,,,0.0,0.0,,,0.0,0.14187861849920602,,,-0.20879207495368401,0.008325757549497012,,,,,,,,,,,-8.884328358208954,-4.525049871415868,,,3.270940784748972,1.0470366887443918,,,3.6749919432806957,1.24752982874078,,,-0.23677048684608404,-0.7476845854272777,,,,,,,-0.2704903202460648,-0.2639374304361769,,,-0.2704903202460648,-0.2639374304361769,,,-0.2704903202460648,-0.2639374304361769,,,-1.458780715977143,-0.1048230899833557,,,-1.0,-0.22068910767407623,,,,,,,-inf,,,,,,,,inf,,,,-0.9555884830525776,-5.296943014816494,,,-0.7279671706350754,2.7474666805490355,,,,,,,-6.553427507185427,-2.059982322864787,,,-4.501308756830085,3.1855883226951316,,,16.18539616778871,6.337491107623644,,,9.83499838865614,3.300865310532595,,,-8.884328358208956,-4.525049871415868,,,-inf,,,,-0.2704903202460647,-0.26393743043617685,,,,,,,,,,,,,,,,,,,2.8731717965509715,0.9587448232320916,,,0.0,0.0,,,2.8731717965509715,0.9587448232320916,,,2.8731717965509715,0.9587448232320916,,,,,,,,,,,,,,,,,,,-0.09313381014749411,-0.005018946796253217,,,,,,,,,,,,,,,,,,,,,,,,,,,,,,,,,,,-0.09313381014749411,-0.005018946796253217,,,,,,,7.595192038766477,3.1095157961760855,,,4.309280882821731,1.651118384668192,,,-0.8291922748358094,-0.2584607510899215,,,4.85453614020525,1.776241671516816,,,7.595192038766477,3.1095157961760855,,,-8.77219607475368,-3.1168751354392175,,,,,,,,,,,,,,,-13.582404152245703,-4.200985570828933,,,,,,,3.7033499853070824,0.007500124022697581,,,,,,,,,,,0.2784289935042432,-0.6710993626404709,,,12.239798201414235,4.021270215199219,,,3.270940784748972,1.0470366887443918,,,2.099972317268364,0.7685698265466501,,,,,,,,,,,,,,,3.0237964031615103,1.5174447707889593,,,,,,,-72.36184524528957,-27.343284399237756,,,,,,,0.14736427266758367,0.1835338203732851,,,0.14736427266758367,0.1835338203732851,,,-2.846040194788691,-2.1502404066484315,,,,,,,,,,,-0.8212970978480154,-1.3086376439508598,,,-0.8212970978480154,-1.3086376439508598,,,2.099972317268364,0.7685698265466501,,,0.2784289935042432,-0.6710993626404709,,,,,,,1.2942243303571428,-0.33930621521939613,,,,,,,,,,,-inf,,,,,,,,-0.9048194436459435,-0.411673106116466,,,,,,,-1.0563858233952703,-3.1006508188793247,,,0.0,-0.04861478736544907,,,,,,,,,,
2008,37778000,2858000.0,34920000.0,0.9243475038382128,0.0,649000.0,1605000.0,2254000.0,2254000.0,91000.0,3135000.0,4463000.0,4379000.0,0.1159,32666000,0.8647,-35885000,-3219000,-0.0852,-1298000,-1921000,-0.0508,-2.62,-2.62,734183,734183,485000.0,2958000.0,3443000.0,1140000.0,,,,,0.0,0.0,0.0,40468000.0,3517000.0,,,59604000.0,59604000.0,7466000.0,48995000.0,0.0,0.0,-46451000.0,10010000.0,0.0,0.0,0.0,47480000.0,47480000.0,94963000.0,0.0,57493000.0,0.0,0.0,-897000.0,0.0,3008000.0,2111000.0,59604000.0,0.0,59604000.0,-1921000,4463000.0,-1299000.0,0.0,-10010000.0,-96000,0.0,-4720000,-10010000.0,10640000,1873000,-973000.0,973000.0,0.0,0.0,-2286000.0,-2286000.0,0.0,0.0,0.0,0.0,102000.0,102000.0,0.0,-311000,485000,796000,900000,34.0,34.0,33.72,800.0,0.0,0.25,33.97,0.4032308170239205,0.0,-3044000.0,-970871.3886300093,59604000.0,29808000.0,-84000.0,28417000.0,2111000.0,2111000.0,2111000.0,0.02382338927418074,0.018585337915234822,0.0,0.04248504420562232,-0.08057599661178463,0.1181375403674096,-0.002223516332256869,0.7890306527608661,0.7522102811159934,0.06900140819200391,0.05966435491555932,51.4558359428099,44.49299425347631,1.2258524100939412,-1.3252826611348942,2.875304930787011,0.0,48995000.0,23.209379441023213,0.009898969282579856,43911000.0,0.896234309623431,45552000.0,5084000.0,,,0.05804195804195804,,0.0577645795584189,4.741828517290384,0.16794174887591437,-0.026794258373205742,2.8388611388611387,0.34395604395604396,,0.7965908328300114,0.8220085900275149,0.7642440104690961,23.209379441023213,27.23495973472288,21.57839886309806,0.03541708610160392,28.23495973472288,27.23495973472288,10.40237497145467,0.07027247678334524,0.4942688675143061,inf,13.129253254167619,0.06398612103275844,37874000,-inf,-14.792816241540864,-0.9099952629085741,19494062.131096613,49594000.0,0.39307299534412654,49594000.0,-0.0016937532766060411,0.572992700729927,0.6338165223810482,,-393.5208333333333,77.89278350515464,0.5858667203543386,0.5858667203543386,-0.019576388043513516,0.6010404484413437,-0.019576388043513516,-0.0014093013891685123,-0.0014093013891685123,0.3270596290701398,-0.9099952629085741,13.461392704879204,2.141583054626533,0.0,0.0,0.0163244077578686,,-0.015049325548620898,,-0.0016106301590497283,1.0,0.0,0.0,0.13840590628295923,6.69723443621319,4.032326092194812,,inf,inf,inf,,0.05228265782733166,1.4582330276986637,0.9800645728687565,,-0.07565249616178715,-0.49741471555511413,1.6879094363123532,,,,,,inf,inf,inf,,-1.047126875532196,,,,-1.0661831635199812,-20.65137151445821,-12.414682662434862,,-1.0661831635199812,1.9973472409453958,,,inf,,,,inf,,,,0.06975071907957808,,,,1.6571601941747574,-0.024154813385842577,-0.10113695882541895,,1.3319919517102616,-0.17859996023963384,-2.89342761985325,,-0.5142024330031825,3.2523458554637372,2.0798289460829538,,-0.5732616098307259,-0.5471823672909603,1.6055105796254239,,-0.4856377031791991,1.983776148829642,2.3743342836926375,,0.27535657686212356,-0.0642338943709126,-0.12518440741646097,,0.11957950065703016,-0.5582522557111905,-3.121218997136184,,0.2614188532555879,-0.05895547444267616,-0.08164316776311545,,0.2849498327759197,-0.049023035053254414,-0.1417038775333938,,0.12638580931263843,-0.5620108187102674,-3.158823633189251,,0.2843137254901962,-0.048728509254494755,-0.14115629747188874,,0.2843137254901962,-0.048728509254494755,-0.14115629747188874,,0.0,0.0,0.0,,0.0,0.0,0.0,,inf,,,,-0.9444287888181254,0.8249370606268899,0.445830601091059,,-0.9353172143004753,0.8279742521327731,0.44765291599458906,,,,,,,,,,,,,,,,,,,,,,,,,,,,,,,,,,inf,,,,inf,,,,,,,,,,,,-0.08887462166376225,1.194479510903365,0.6822707135638726,,-0.08887462166376225,1.194479510903365,0.6822707135638726,,,,,,inf,,,,,,,,,,,,,,,,,,,,,,,,,,,,,,,,inf,,,,,,,,0.5469813964096049,2.4645243258357983,1.408255025986503,,,,,,-0.06341836900922038,2.2610577373628566,1.2861750729027381,,,,,,,,,,-1.8759765625,-0.9527849771137503,-0.5357541115876805,,,,,,0.0,0.7612809315866085,0.45683932634130364,,-0.4764384920634921,-0.32391783224717813,-0.1818963080124739,,-0.08887462166376225,1.194479510903365,0.6822707135638726,,,,,,-0.08887462166376225,1.194479510903365,0.6822707135638726,,0.2849498327759197,-0.049023035053254414,-0.1417038775333938,,0.06975071907957808,,,,-inf,,,,,,,,,,,,-1.081771720613288,-1.3153844154935384,-1.6704066735168457,,,,,,-71.44776119402985,-24.60521968948071,-15.655887500799807,,-inf,,,,-5.369609856262834,-2.633803604082382,-1.948972387399877,,6.739669421487603,0.9098703392845331,0.2183004758807095,,-0.5868365180467091,,,,inf,,,,,,,,,,,,0.524,,,,-0.40700389105058365,,,,-1.0,,,,,,,,,,,,,,,,-0.9944864864864865,,,,-0.9476654694715239,,,,,,,,-0.8131009615384616,-7.559571203253268,-3.400640480278298,,-0.39070351758793975,3.459888950927477,1.8930212372654118,,-0.6764227642276424,40.167382888114595,23.89782858317954,,-1.4259346900141978,-4.741102175494674,-3.172283032986815,,-0.028710184259391425,-0.0051911703329010255,0.08250969707027977,,-0.021582733812949617,-0.009575196985268911,0.0842240169525118,,-0.021474172954149773,-0.009558902748857586,0.08620579676901714,,0.6000000000000001,-0.04999999999999997,0.03222222222222224,,,,,,0.0,0.0,inf,,-0.02131950446557196,-0.009490178071285235,0.08746784260268356,,-0.010928491575922905,0.008771106800477213,0.019238829378716925,,,,,,-inf,,,,-0.5405246622669146,-4.445965499578913,-2.995201027437358,,-0.08887462166376225,1.194479510903365,0.6822707135638726,,0.02740150966807975,1.37954502122901,0.9561484455421173,,-0.9667194928684628,-0.4782592509477747,-0.3735996213625782,,,,,,-0.4764384920634921,-0.32391783224717813,-0.1818963080124739,,-0.4764384920634921,-0.32391783224717813,-0.1818963080124739,,-0.4764384920634921,-0.32391783224717813,-0.1818963080124739,,-1.374150105567292,-1.481300194216806,-0.523831640488124,,inf,inf,inf,,,,,,-1.0413972514303542,,,,-inf,,,,-0.06030817902864627,,,,-0.9707656935475657,-0.9217092116575231,-3.3393935508343815,,-0.09750862675802763,-0.5080814625266855,1.6289782829778159,,,,,,-1.1362360950655293,-2.5986829451573237,-1.5691047099559854,,-1.0581367007626283,-2.0967535405220405,1.5938575562405455,,0.13840590628295923,6.69723443621319,4.032326092194812,,-0.5142024330031826,3.2523458554637377,2.079828946082954,,-1.4259346900141978,-4.7411021754946745,-3.1722830329868152,,-0.5868365180467091,,,,-0.4764384920634921,-0.32391783224717813,-0.1818963080124738,,,,,,inf,,,,inf,,,,,,,,-0.17505495124837966,1.0813950064834719,0.5997053686050082,,-0.9909471281856219,-0.3303157093952073,-0.19818942563712438,,-1.8557741080989687,0.5211552875332753,0.26356153723489034,,-1.095511845046873,0.7745760418839739,0.41561398984530945,,,,,,,,,,,,,,,,,,-0.9290078102997869,-0.3062962298308045,-0.19790276532070245,,,,,,,,,,-1.0,,,,,,,,,,,,,,,,,,,,inf,,,,-1.9392495571374124,-0.6430434787766798,-0.3999511146882276,,inf,,,,0.7888664785195754,3.569195042759024,2.023573632012154,,-2.63452449258884,0.8897439629992863,0.45472531552416645,,-0.4253683188009114,-0.5671353923434782,-0.24020145357801334,,0.7402451565379966,2.1341982523686966,1.2138453865634993,,0.7888664785195754,3.569195042759024,2.023573632012154,,-1.3220634231895638,-3.0276716938327155,-2.223737433186132,,-1.0,,,,,,,,,,,,-0.6475253418879185,-3.959486575021076,-2.7339976020605126,,,,,,0.1831557901971197,0.6561296512348869,-0.004311572558878929,,,,,,,,,,1.4542480936771711,0.5174347464906308,0.015013771612487892,,-0.5105482546603961,3.972109982146678,2.4919574740813415,,-0.24189061114677912,1.1434741810756928,0.6516675156672692,,-0.35437846762458747,0.530892589749164,0.4708194445172353,,,,,,,,,,,,,,0.2494503318102581,1.8918517710907212,1.0562475063243095,,,,,,-14.921755562252022,-31.97661578041826,-18.307235723292013,,-1.0,,,,0.15492629537863878,0.10569183176752135,0.21697879835083547,,0.15492629537863878,0.10569183176752135,0.21697879835083547,,-0.3939194732463004,-2.106222442442673,-1.5483752320235875,,,,,,,,,,-0.9634731861027632,-0.7454092794405259,-0.8332750727879128,,-0.9634731861027632,-0.7454092794405259,-0.8332750727879128,,-0.462805276883662,0.49475031999613917,0.4491340826654204,,1.4542480936771711,0.5174347464906308,0.015013771612487892,,,,,,-2.4668769551421867,-0.3776604126359832,-0.6196218555402656,,,,,,,,,,-0.5465349865374742,,,,,,,,-1.9614226354879705,-1.1433872055374141,-0.6036620124560729,,,,,,-1.0897480440755665,-1.1970328027823658,-2.2322183949927528,,0.0,0.0,-0.04223565963985056,,,,,,,,,
2009,32821000,27331000.0,5490000.0,0.1673,0.0,581000.0,5141000.0,5722000.0,33053000.0,105000.0,3079000.0,4457000.0,5724000.0,0.1744,-232000,-0.0071,-1580000,-1812000,-0.0552,-191000,-1621000,-0.0494,-2.21,-2.21,734183,734183,209000.0,5987000.0,6196000.0,1271000.0,0.0,5393000.0,12860000.0,0.0,0.0,0.0,0.0,2409000.0,0.0,37315000.0,39724000.0,0.0,52584000.0,8531000.0,1811000.0,0.0,0.0,2213000.0,12555000.0,46757000.0,0.0,0.0,0.0,46757000.0,0.0,0.0,59312000.0,0.0,0.0,-9736000.0,-27414000.0,30422000.0,-6728000.0,52584000.0,0.0,52584000.0,-1621000,4457000.0,0.0,0.0,10315000.0,-131000,0.0,916000,305000.0,-10201000,2950000,-1304000.0,1304000.0,-535000.0,0.0,-1304000.0,-1839000.0,-1260000.0,0.0,0.0,-425000.0,298000.0,-1387000.0,0.0,-276000,209000,485000,1646000,17.175,17.175,17.035,700.0,0.0,0.25,17.285,0.1054083885209713,0.0,-2974000.0,-1108447.5717439293,52584000.0,452000.0,1267000.0,14731000.0,-6728000.0,-6728000.0,-6728000.0,0.05015081807379422,0.10582877959927141,0.0,0.15663751866183237,-0.0906127174674751,0.13579720301026782,0.03860333323177234,0.013771670576764877,0.4488284939520429,-24.663793103448278,0.17433959964656776,44.70411327965916,-0.3159975101575493,2.2419478522384746,-1.776123936402777,-9.163927794568929,-0.5788747492110278,48568000.0,-7.218787158145066,0.004303244934936583,8605000.0,0.1771742711250206,42372000.0,39963000.0,305000.0,1.0242931103146158,0.027080844285145362,0.4818040435458787,0.11783051878898525,-1.8660820451843043,0.23876083979917845,0.4114972393634297,1.207168458781362,0.4935085623257666,0.005800243420051727,0.8891868248897002,0.9236269587707288,0.8057964399817436,-7.218787158145066,-8.815695600475625,-6.297859690844233,-0.12794766468887875,-7.815695600475625,-8.815695600475625,7.40251572327044,0.1275737110854884,0.24836458052333424,0.035203285069615245,10.36198462613557,0.06339565145774996,32952000,-inf,-9.087600246761259,0.2409334126040428,-207545.25386313465,40029000.0,-0.0051848723141506075,40029000.0,0.03165205226210997,0.368008194059307,0.6241632435721892,inf,-250.54198473282443,157.03827751196172,0.10440438156093108,0.10440438156093108,-0.02769111323650177,0.011291813435259437,-0.02769111323650177,0.024094781682641106,0.024094781682641106,-0.003946927846172499,0.2409334126040428,-2.1895065398335314,0.16649548069022185,0.0,-0.0,0.024798417769663777,inf,-0.1851513768446676,0.0,-0.0024912520918910696,0.7378161628624306,-0.25820170109356017,-0.07424877707896575,-0.13121393403568216,5.397529380011996,3.8039330590236418,,8.5629811056683,inf,inf,,-0.8427835051546392,1.0366080065908383,0.6365635420508181,,-0.8190074627720504,-0.5365050818025177,1.5376381687537002,,,,,,-0.10477657935285056,inf,inf,,2.203115264797508,-inf,,,1.5385980479148182,-20.232987735825983,-12.096238892312302,,13.664152617568767,6.521506387217042,-inf,,0.15384615384615374,,,,-0.01786283891547047,,,,-0.0013443871835088217,inf,,,0.30714775062799715,0.15532369453308226,-0.3080624371673005,,0.5047454702329595,0.2692390729144693,-2.825419364405165,,-1.007102185758893,2.7712312566313546,1.6762582625671416,,-1.0082109402104775,-0.6503308159948374,1.4038683915833283,,-0.9559704611954856,1.6307152154001059,2.132868967514991,,-0.4370922646784716,-0.13283539155414403,-0.4809578888196362,,-0.352112676056338,-0.3960326046535199,-3.2245823709459587,,-0.8528505392912172,-0.3291861488663365,-0.5590414992364137,,-0.1561686621551276,0.02046916542007271,-0.41701569724977705,,-0.027559055118110187,-0.2822808140959411,-3.1851785355477675,,-0.1564885496183207,0.021201664128545628,-0.41689845183999735,,-0.1564885496183207,0.021201664128545628,-0.41689845183999735,,0.0,0.0,0.0,,0.0,0.0,0.0,,-0.5690721649484536,,,,1.024002704530088,0.9842485707543114,0.5911616770816476,,0.7995933778681383,0.9124826533728783,0.5481021266527877,,0.11491228070175441,,,,,,,,,,,,,,,,,,,,,,,,,,,,,,,,-0.9404714836413957,,,,-1.0,,,,,,,,,,,,-1.0,0.7273553876950699,0.41044708891388265,,-0.11777733038051141,1.0214296109015661,0.5868916228377804,,0.14264666488079292,,,,-0.9630370445963874,,,,,,,,,,,,-1.0476416008266776,,,,0.25424575424575435,,,,inf,,,,,,,,,,,,-1.0,,,,-0.015227464195450735,,,,-1.0,1.605752396011237,1.1363777214498856,,,,,,0.03163863426851954,1.7461653522944687,1.2206254952198248,,,,,,,,,,9.853957636566332,2.4614971980379896,1.314793334646812,,-inf,,,,9.113696808510639,3.037898936170213,2.279507920654093,,-4.187115111321649,-1.6446813078770688,-1.0910731789387345,,-0.11777733038051141,1.0214296109015661,0.5868916228377804,,,,,,-0.11777733038051141,1.0214296109015661,0.5868916228377804,,-0.1561686621551276,0.02046916542007271,-0.41701569724977705,,-0.0013443871835088217,,,,-1.0,,,,,,,,-2.0304695304695306,,,,0.36458333333333326,-0.6526696333668225,-1.4601748521946738,,,,,,-1.1940677966101694,-24.541402228863173,-15.768076257051792,,-1.0304695304695304,,,,-1.9587406015037594,-3.2099311787780684,-2.305565025952598,,0.5750133475707422,2.405889281228404,0.5053693175293128,,0.34018499486125386,-inf,,,0.34018499486125386,,,,-inf,,,,,,,,-0.42957130358705164,-inf,,,-0.1955380577427821,6.6047082392911,,,-inf,-inf,,,,,,,,,,,-inf,,,,1.9215686274509802,,,,-14.598039215686274,,,,,,,,-0.112540192926045,-6.944910687851806,-3.224917427203837,,-0.5690721649484536,1.8035315626113257,1.797833223281081,,-0.39070351758793975,40.310957906061475,24.002934190641493,,0.8288888888888888,-3.1604580531114213,-2.8344390830745825,,-0.4948529411764706,-0.17125165386061025,-0.02061889532301848,,-0.4948529411764706,-0.17214522499647342,-0.017241373777584834,,-0.4948102016607354,-0.17209479153829507,-0.017243965832393272,,-0.125,0.15833333333333335,-0.03277777777777775,,,,,,0.0,0.0,0.0,,-0.4911686782455107,-0.17082939423702756,-0.01737046544269292,,-0.7385904448004572,-0.31943700377668804,-0.14490833274557782,,,,,,-0.022996057818659654,,,,0.14170381857482983,-3.0943830673003467,-2.7947940915879377,,-0.11777733038051141,1.0214296109015661,0.5868916228377804,,-0.9848362855609233,0.9058523891292841,0.5570309420658994,,-16.083333333333336,-5.762274437682628,-3.858621316496726,,-0.4816131189076961,,,,-4.187115111321649,-1.6446813078770688,-1.0910731789387345,,-4.187115111321649,-1.6446813078770688,-1.0910731789387345,,-4.187115111321649,-1.6446813078770688,-1.0910731789387345,,1.105108450213109,-0.5759407904437753,-0.11670218506085002,,4.694207987067115,inf,inf,,,,,,2.6868860934621206,-inf,,,0.12456216835948575,,,,0.14948392008108846,inf,,,-18.361389557498754,-6.762581244699632,-7.044596859099161,,-0.9825460892696919,-0.6026739622209316,1.4324690651238776,,-0.40332044746031337,,,,-358.4389820395925,-122.04288188061447,-73.15103302065049,,1.9220059429671856,-1.2124798382085091,2.08412684205799,,-0.13121393403568204,5.397529380011996,3.8039330590236418,,-1.007102185758893,2.771231256631355,1.676258262567142,,0.8288888888888888,-3.1604580531114217,-2.8344390830745825,,0.34018499486125386,-inf,,,-4.187115111321649,-1.6446813078770688,-1.0910731789387345,,-inf,,,,-0.008715175017859011,,,,-1.3110288741880647,,,,-0.5652835348717157,,,,-0.8040354353123363,0.6313604699967518,0.3794288166271118,,-0.8023125546270778,-0.5977532276042332,-0.3586519365625399,,-0.06981032665964171,0.31586245393078705,0.190130006987533,,6.860542879622344,2.8794009437088146,1.7282531008543498,,,,,,,,,,-0.5334264177378569,,,,,,,,1.0398403258491653,0.00589956846729478,0.01915513503212376,,-1.3935363833550516,,,,0.4216884211179053,,,,-16.357664826242285,,,,-0.5747701631980351,,,,0.43480125149024795,,,,,,,,0.11624034352834234,,,,0.12362202776957898,,,,0.05437063155672295,-0.6593375785760612,-0.3799871531938898,,-1.3110288741880647,,,,-1.323690421661838,2.3534560318747384,1.7587446890771985,,-1.2918594530947527,0.12763231237937944,0.2053942416641968,,-4.612597160642316,-1.9557192514263457,-1.1626695465425985,,-1.276809164025972,1.4393240442390915,0.9584322014124945,,-1.323690421661838,2.3534560318747384,1.7587446890771985,,-0.2883821489242786,-3.4608805489558407,-2.192214195686299,,0.8154150376513227,,,,-0.49751117894119523,,,,-1.0,,,,-0.2107712125328708,-4.813566902222164,-2.692250653381518,,-0.009228088302245752,,,,-0.12995722659344144,1.2521828496369203,0.015139787134354243,,,,,,-0.38567476953836166,,,,-1.2647633701234433,0.15597123901932367,-0.364762672873537,,-1.0106465883030127,3.5728677861502756,2.1085231605268495,,-0.1928660725087712,0.9453947003644739,0.5412706765155251,,-1.0131906093157363,0.24413441344268008,0.18762808053992527,,-0.1928660725087712,,,,-19.68752237960812,,,,-0.35774366132324764,,,,-0.015230399442088816,1.08600544517656,0.9573108489470096,,,,,,-0.36333234860630137,-29.21564438538263,-19.46298822171432,,1.0160824975726994,,,,-0.8217949954594004,-0.1731681424710593,-0.023253447792181258,,-0.8217949954594004,-0.1731681424710593,-0.023253447792181258,,0.4145159553923434,-0.9418145708808826,-1.2860249475598504,,-0.9812128893079624,,,,0.4145159553923434,,,,-18.096968659668338,-6.627246314539707,-4.597270955524737,,-18.096968659668338,-6.627246314539707,-4.597270955524737,,-1.0120679151303202,0.20836637508479403,0.16616725752519362,,-1.2647633701234433,0.15597123901932367,-0.364762672873537,,-1.1626508183688844,,,,-0.9222558843419422,-0.698302836375662,-0.8814102970284635,,,,,,,,,,0.519100609191202,-inf,,,,,,,11.302968411872428,2.812242110912838,1.6213052916070119,,,,,,0.5467561425528678,-0.5331259083059897,-1.9689888716321342,,-0.26218383713756943,-0.08739461237918981,-0.08160563984678333,,-inf,,,,-inf,,,
2010,32680000,27223000.0,5457000.0,0.167,0.0,606000.0,4747000.0,5353000.0,32576000.0,162000.0,3194000.0,4747000.0,3806000.0,0.1542,104000,0.0032,-4239000,-4135000,-0.1265,-1181000,-1720000,-0.0526,-2.34,-2.34,734183,734183,522000.0,0.0,522000.0,1573000.0,0.0,6452000.0,8547000.0,0.0,0.0,0.0,0.0,4836000.0,0.0,34681000.0,39517000.0,0.0,48064000.0,7763000.0,0.0,0.0,0.0,305000.0,8068000.0,49678000.0,0.0,0.0,0.0,49678000.0,0.0,0.0,57746000.0,0.0,0.0,-2860000.0,-32208000.0,35216000.0,148000.0,57894000.0,-9830000.0,48064000.0,-1720000,4747000.0,0.0,0.0,174000.0,-302000,0.0,515000,479000.0,135000,3336000,-1409000.0,1409000.0,-690000.0,0.0,-1409000.0,-2099000.0,-1613000.0,0.0,0.0,0.0,689000.0,-924000.0,0.0,313000,522000,209000,1927000,23.745,23.745,23.545,1600.0,0.0,0.25,23.795,0.28561064087061666,0.0,-3032000.0,-354759.6130592502,48064000.0,104000.0,-941000.0,6206000.0,148000.0,148000.0,148000.0,0.058965728274173804,0.11105002748763057,0.0,0.14525703794369646,-0.09277845777233783,0.14525703794369646,-0.02879436964504284,0.003182374541003672,0.18990208078335374,51.47115384615385,0.16380048959608323,44.51206306874444,0.1416540562775221,2.6246862158344717,-1.9191400509137369,0.20158461854878143,0.0,49678000.0,335.6621621621622,0.01050766939087725,5358000.0,0.10785458351785498,49156000.0,44320000.0,479000.0,1.0593703520079325,0.10213187902825979,0.061074061074061076,0.01086051930758988,54.513513513513516,0.1678595206391478,-0.2946149029430182,0.7692117005453644,0.06470004957858205,0.009965878828229028,1.0335802263648468,1.0335802263648468,1.022719707057257,335.6621621621622,390.1756756756757,332.13513513513516,0.0030792276964047936,324.7567567567568,390.1756756756757,12.915396741986337,0.01050766939087725,0.10747064731756312,0.03878980635291276,15.172359432475039,0.06429405370586577,32982000,-inf,-3.608139534883721,-11.621621621621621,74296.49334945586,49826000.0,0.0014911189609733044,39996000.0,-0.023527352735273527,0.15516551655165517,0.6799267643142477,inf,-108.21192052980132,62.60536398467433,0.11353611850865512,0.11353611850865512,-0.00711996975593566,0.0026002600260026003,-0.008869877314212675,-0.01957806258322237,-0.01957806258322237,0.0015457825680229667,-11.621621621621621,41.932432432432435,0.6013986013986014,0.0,0.0,0.029315079893475367,inf,-0.05950399467376831,0.0,-0.006283288948069241,1.0,0.0,0.0,-0.004296029980805027,0.0009653140888240171,3.991238668924617,,-0.0039515568402180845,inf,inf,,-0.006010928961748596,-0.2655039254296854,0.7051809297959206,,-0.001793185893604221,-0.2988177149424806,-0.4626089590661994,,,,,,0.04302925989672968,inf,inf,,-0.07663878622836029,0.3597832010123172,,,-0.06448794127927293,0.13597564770518802,-12.096000887347817,,-0.01443136780322507,4.194512695415187,3.9283525945203466,,0.5428571428571429,inf,,,0.037349788892497626,inf,,,0.06506618801884678,0.044490839971638683,,,-0.3350803633822502,0.5430758604735014,-0.020079410582356138,,-0.11582568807339444,0.5736372446232756,-0.029376019711867273,,-1.4482758620689655,-0.9898601602770137,1.4603319037126705,,-1.4507042253521127,-1.0107255917977722,-0.8200924534870943,,1.6829113924050634,0.08043440934345958,1.3356538755397007,,1.2820088300220749,0.37342438073524226,0.1304429764461731,,1.2916666666666665,0.35304449708911956,-0.1470405553046486,,5.183246073298429,1.5306047957542666,0.8307058221358368,,0.06107341147439849,0.06328486069839685,-0.04843287116809847,,0.06477732793522262,0.05453469404325029,-0.329762836662738,,0.05882352941176472,0.06221623509454673,-0.04877010959400805,,0.05882352941176472,0.06221623509454673,-0.04877010959400805,,0.0,0.0,0.0,,0.0,0.0,0.0,,1.4976076555023923,inf,,,-1.0,-0.3068086947626792,0.49976277728215146,,-0.9157520981278244,-0.35049197818672045,0.47355280722772664,,0.23760818253343818,,,,,,,,0.196365659187836,,,,-0.33538102643856915,,,,,,,,,,,,,,,,,,,,1.0074719800747198,inf,,,,,,,-0.07058823529411762,,,,-0.005210955593595856,,,,,,,,-0.08595770576601247,-0.09753655260342871,0.6759406993127144,,-0.09002461610596646,,,,-1.0,inf,,,,,,,,,,,-0.8621780388612743,,,,-0.3573874950219036,,,,0.062471929336783694,,,,,,,,,,,,,,,,0.062471929336783694,,,,,,,,,,,,-0.026402751551119485,-0.019394162097273442,1.357681818961194,,,,,,,,,,-0.7062448644207067,2.4239120698818746,1.2578715681608745,,0.17487415189319333,,,,0.15758332785484197,3.090426712121827,2.3110245862250616,,-1.021997621878716,-1.8951837417546191,-1.23617324598838,,0.10098128708352361,-0.035223554986916684,0.7133284978826215,,-inf,,,,-0.08595770576601247,-0.09753655260342871,0.6759406993127144,,0.06107341147439849,0.06328486069839685,-0.04843287116809847,,0.06506618801884678,0.044490839971638683,,,,,,,,,,,-0.9831313620940378,,,,1.3053435114503817,0.19605170805680902,-0.45524528033938017,,,,,,-0.43777292576419213,-24.35986730546807,-15.089499958163298,,0.5704918032786885,-inf,,,-1.0132339966669934,-2.780528151477862,-2.17467708208358,,0.13084745762711858,2.4818434088951546,0.687094364610292,,0.08052147239263796,-0.05537668359760576,,,0.08052147239263796,inf,,,0.2897196261682242,,,,,,,,0.08052147239263796,0.05831672293519544,,,0.1413811854268625,-0.15372025445550108,,,0.28015873015873005,-inf,,,,,,,,,,,-1.0,,,,1.3120805369127515,0.7463875592924151,,,-0.33381398702235043,-5.293172890726717,,,,,,,-2.1340579710144927,-1.0198997084929997,-4.9850623547400685,,1.4976076555023923,0.17927732432199964,2.2616404686672738,,-0.5690721649484536,-0.5453994822546786,23.90847459636148,,0.1707168894289186,-0.14210963723213013,-2.6447401496332428,,0.38253275109170315,-0.047010124781386296,-0.025578740216694106,,0.38253275109170315,-0.044634307965905694,-0.028209156208114837,,0.3821543880246552,-0.04470999553007667,-0.0282665043765306,,1.2857142857142856,0.5869047619047619,0.20214285714285712,,,,,,0.0,0.0,0.0,,0.3766271333526179,-0.04528701645282159,-0.028602415821349703,,1.7095627290971591,0.320014597573593,0.1994571209396267,,,,,,0.0195023537323471,-inf,,,-0.6799491269568085,-0.3595899902162978,-2.7752283614237436,,-0.08595770576601247,-0.09753655260342871,0.6759406993127144,,-0.7699115044247787,-0.5757820934392074,0.47677745474026567,,-1.7426992896606155,-6.264250705287471,-3.852162075167455,,-0.5787115606544022,,,,-1.021997621878716,-1.8951837417546191,-1.23617324598838,,-1.021997621878716,-1.8951837417546191,-1.23617324598838,,-1.021997621878716,-1.8951837417546191,-1.23617324598838,,0.17576802411097092,-0.03109121041440403,-0.6326048216652675,,0.04933674854921133,inf,inf,,,,,,-0.07265488380664042,0.5242779860750421,,,0.0239010633980834,-inf,,,0.0696614858312905,0.05294574229457757,,,-1.7459037143803875,-7.026019655142235,-4.574484181370342,,-0.768918772543625,-0.6163244961904482,-0.6551418498786746,,-0.5768938840954142,,,,-3.0869115156077753,-120.8873765500886,-73.86438847813444,,-0.06045161324134085,0.26780587632107217,-0.8857412583680555,,-0.004296029980805027,0.0009653140888240541,3.991238668924617,,-1.4482758620689655,-0.9898601602770137,1.460331903712671,,0.1707168894289186,-0.14210963723213013,-2.644740149633243,,0.08052147239263796,-0.05537668359760576,,,-1.021997621878716,-1.8951837417546191,-1.23617324598838,,-1.0,,,,0.022854554439136976,inf,,,-47.49841515044941,inf,,,1.4418013730915136,,,,-0.3773387565368972,-0.4521430476992044,0.4125621655202362,,-0.39125143378324456,-0.728170372198648,-0.4369022233191888,,0.16010573019918817,-0.5884929015198074,0.3307522532278745,,0.10902584891024203,1.958018961161904,1.8586593708369015,,0.5704918032786885,,,,0.034245316443203055,,,,2.77136982705824,,,,-0.8732387951238822,,,,-0.9078293177420422,-0.2656656007308879,-0.15737553627705808,,-30.212817118193463,,,,-0.296955393605022,,,,-1.7159583947604995,-6.357874407000928,,,-0.3627967207477534,,,,-0.8688978175501779,,,,0.7181828600117874,,,,0.16238814772481347,,,,0.11904510424907566,inf,,,0.26920355602517687,-0.5385584565185042,-0.32111124974962785,,-47.49841515044941,inf,,,-45.25920464570316,-15.264676196281806,-7.175061987817585,,-53.73777941067661,-19.2213877854534,-10.4720813949547,,-1.0240663063596536,-2.020677261934294,-1.467613928806481,,-42.55186861896127,-14.362810875483083,-7.485216605176231,,-45.25920464570316,-15.264676196281806,-7.175061987817585,,0.7447307408460726,-0.28857161042258994,-1.7253332979152707,,-0.9176345243744147,-0.36740649557436394,,,-0.5672867399566015,,,,0.1018803011197702,,,,0.46423296114592527,-0.13135453109162135,-2.324999595290035,,0.01417135446134754,,,,0.0009104151493080082,0.01803632625099542,0.36786842845210554,,,,,,-0.6029601394306896,,,,-49.23582373243077,-16.348779669625678,-9.789656572616462,,-1.3579773180380725,-0.9597240536671604,1.9095412080197895,,0.24474755802043524,-0.06333637521170503,0.6964608057477485,,-1.2875902955032714,-0.8850531241478651,-0.14162062711430318,,-0.0008244023083264773,,,,-1.743312077853405,,,,-0.57836396293217,,,,0.08934124416380995,0.10785372551065975,1.149933231598777,,,,,,-0.5680886752565744,-5.284392195371633,-19.372253673023533,,-0.6013369162183684,-0.19508480621522298,,,0.08746507389055025,-0.19313454206340377,-0.08345088525325721,,0.08746507389055025,-0.19313454206340377,-0.08345088525325721,,-0.7428788905983641,-0.24076080281744036,-1.3294060525068079,,-0.7697216624317299,,,,-0.6796850585797103,,,,-1.8125436802495383,-6.957661842006879,-4.42914803564789,,-1.8125436802495383,-6.957661842006879,-4.42914803564789,,-1.3916419626272056,-0.9555050515470627,-0.18389178355382169,,-49.23582373243077,-16.348779669625678,-9.789656572616462,,-20.151544729170148,,,,2.6121016552848753,-0.25901039473308457,0.1113729066069967,,,,,,,,,,0.18213509288229202,0.051566905178673274,,,,,,,-0.678619755964931,2.8876420068065087,1.438837407859051,,,,,,1.522140962177656,0.32638302021831905,-0.3044402607233148,,0.3553511705685619,0.031055777810330826,0.018633466686198495,,-1.0,,,,-1.0,,,
2011,36282000,29299000.0,6983000.0,0.1925,0.0,572000.0,3467000.0,4039000.0,33338000.0,486000.0,3077000.0,3467000.0,11348000.0,0.3076,2944000,0.0811,1860000,4804000,0.1324,1727000,2889000,0.0796,3.93,3.93,734183,734183,610000.0,0.0,610000.0,1683000.0,0.0,5175000.0,7468000.0,0.0,0.0,0.0,0.0,10779000.0,0.0,33062000.0,43841000.0,0.0,51309000.0,7961000.0,2786000.0,0.0,0.0,1988000.0,12735000.0,45179000.0,0.0,0.0,0.0,45179000.0,0.0,0.0,57914000.0,0.0,0.0,29000.0,-35600000.0,38608000.0,3037000.0,60951000.0,-9642000.0,51309000.0,2889000,3467000.0,0.0,0.0,-5746000.0,-110000,0.0,198000,-5267000.0,2943000,3553000,-1773000.0,0.0,0.0,0.0,21000.0,-1752000.0,-1713000.0,0.0,0.0,0.0,0.0,-1713000.0,0.0,88000,610000,522000,1780000,23.5,23.0,22.81,900.0,0.0,0.25,23.06,0.35949208992506243,0.0,-2591000.0,-190842.83930058288,51309000.0,2944000.0,7881000.0,-1062000.0,3037000.0,3037000.0,3037000.0,0.049060140014332176,0.08191321781469282,0.0,0.09555702552229756,-0.07141282178490711,0.09555702552229756,0.21721514800727634,0.08114216415853591,-0.02927071275012403,1.3719429347826086,0.11132241883027397,49.41819682558708,4.009899439240625,2.424463655519128,-2.414929247885064,4.136570854950333,0.0,47965000.0,15.793546262759302,0.012717606588137184,11389000.0,0.23744396956113833,47355000.0,36576000.0,-5267000.0,0.5864153906556734,0.05653710247349823,0.08168184252811998,0.011888752460581964,4.193282844912743,0.24820206981231363,2.5612609684757883,-0.0833922261484099,0.04789948959560267,-0.10265255608177902,0.8805277826502174,0.9348262488062523,0.9229374963456703,15.793546262759302,19.069476457029964,15.592690154757985,0.0591903954471925,16.89463286137636,19.069476457029964,4.172982023264011,0.012717606588137184,-0.018337534965638707,0.03939883574226964,5.103454353189989,0.06415094339622641,36392000,-inf,-0.367601246105919,0.9512676983865657,1885655.2872606162,48216000.0,0.03910849691514469,38574000.0,0.20430860164877898,-0.027531497900139992,0.7071274045489095,inf,-329.8363636363636,59.47868852459016,0.13609698103646534,0.13609698103646534,-0.003958081120387068,0.07632083787006792,-0.004947447485367939,0.15359878383909256,0.15359878383909256,0.03675096546922794,0.9512676983865657,-0.34968719130721104,99.62068965517241,0.0,0.0,0.034555341168216104,inf,0.0005652029858309458,0.0,-0.002143873394531174,1.0,0.0,0.0,0.11022031823745415,-0.008429881926344343,3.259702485658527,,0.07625904565991992,2.8784295314960002,inf,,0.27964082829393444,-0.18971786860748444,0.6766907838209402,,0.15269461077844304,-0.22270201262907052,-0.2917227641045428,,,,,,-0.05610561056105612,-0.039284310005725666,inf,,-0.26964398567516323,0.6189441642979948,-inf,,-0.24546983000186806,0.40954675887789244,-12.201784195751818,,0.023391453831041353,4.557704234532195,3.9146958495357884,,2.0,0.8989010989010988,,,-0.0366311834690044,-0.005714744497325748,,,-0.26964398567516323,-0.06864072827994176,inf,,1.981607987388334,0.6512251248780271,0.4224997415210662,,0.994811932555123,0.461243904904896,0.33734069264502725,,27.307692307692307,8.28410475328815,6.834622043103482,,24.34375,7.29494494481247,4.1884106653326745,,-1.4387827317763624,-0.2372806001889282,1.027254861365804,,-2.161789600967352,-0.4389576785412496,-0.25565738912154184,,-2.0466403162055338,-0.36902877519840177,-0.3886142926998854,,-2.462320067739204,0.6226918220893359,0.3466735117920431,,-2.6796511627906976,-0.9249154711571422,-0.5114340510112162,,-2.513307984790875,-0.8253632373245875,-0.6590746198286952,,-2.6794871794871797,-0.9257173998979119,-0.5114117315379556,,-2.6794871794871797,-0.9257173998979119,-0.5114117315379556,,0.0,0.0,0.0,,0.0,0.0,0.0,,0.1685823754789273,0.3657059553442887,,,,,,,0.1685823754789273,0.017474551739747064,0.3980556474939475,,0.06993006993007,0.14081684438842088,,,,,,,-0.19792312461252326,,,,-0.12624312624312628,,,,,,,,,,,,,,,,,,,,1.2289081885856081,0.43196956167297745,,,,,,,-0.04668262160837344,,,,0.10942126173545552,,,,,,,,0.06751414780292952,-0.04540696278119812,0.6091690549483231,,0.025505603503800156,0.026042550759542205,,,inf,inf,,,,,,,,,,,5.518032786885246,1.2027377157324313,,,0.5784581060981655,0.15843878844067208,,,-0.09056322718305887,inf,,,,,,,,,,,,,,,-0.09056322718305887,-0.01443958734724197,,,,,,,,,,,0.0029092924185225577,0.00271505837864087,1.0430005195501617,,,,,,,,,,-1.0101398601398601,2.712524304001922,1.1336213739106806,,0.10531544957774464,-inf,,,0.09631985461154025,3.1225333303256737,1.8735199981954043,,19.52027027027027,4.770385845689969,2.71284574495207,,0.05280339931599132,0.012002452006334504,0.6436147038208426,,-0.019125127161749744,,,,0.06751414780292952,-0.04540696278119812,0.6091690549483231,,-2.6796511627906976,-0.9249154711571422,-0.5114340510112162,,-0.26964398567516323,-0.06864072827994176,,,,,,,,,,,-34.02298850574713,-12.345529799436898,,,-0.6357615894039735,0.3447217517932472,-0.25768539561081183,,,,,,-0.6155339805825243,-0.7491249009856286,-14.935502718587248,,-11.995824634655532,-4.151934120615458,,,20.8,5.942675133943083,2.0313944933997603,,0.06504796163069537,0.25696958894285205,1.4827126525886052,,0.25833924769339967,0.22634857164909716,-inf,,-1.0,-0.19309784424870272,,,-1.0,-inf,,,,,,,-1.014904187366927,-0.45465133952044684,-inf,,-0.1653168175321582,-0.07315789661602594,3.9580378171536013,,0.061996280223186595,-inf,-inf,,,,,,,,,,,,,,-1.0,0.7445497214545772,,,0.8538961038961039,-4.69265236627084,,,,,,,-0.7188498402555911,-0.9884826680653762,-4.7375279749651,,0.1685823754789273,0.3657059553442887,1.4153569437630593,,1.4976076555023923,0.17927732432199964,24.37228184174767,,-0.07628437986507519,0.30777379948424405,-1.877388329954084,,-0.010317961676142406,-0.04087938392030329,-0.028308034433254005,,-0.03137502632133082,-0.047898405468699425,-0.03305559004380958,,-0.031216818857507045,-0.047957544164529096,-0.03306936108954741,,-0.4375,0.24107142857142852,0.2646428571428571,,,,,,0.0,0.0,0.0,,-0.03088884219373833,-0.048476795695543716,-0.03334997831044062,,0.25867890926344894,0.40988373118671695,0.20198612540610877,,,,,,-0.1454485488126649,-0.049647417632992484,,,-0.4620502665033934,-0.33343185829512406,-2.0850297190722484,,0.06751414780292952,-0.04540696278119812,0.6091690549483231,,27.307692307692307,8.517648172568867,5.8510675941310755,,-9.375132837407014,-9.067055153466988,-5.680931088023103,,-1.1711247180148243,-0.7438164658589742,,,19.52027027027027,4.770385845689969,2.71284574495207,,19.52027027027027,4.770385845689969,2.71284574495207,,19.52027027027027,4.770385845689969,2.71284574495207,,-0.16798890728159022,0.37096252234749655,-0.3440086509003891,,-0.2623755286884839,1.4937230689759475,inf,,,,,,-0.3421521815739027,0.7573596760271926,-inf,,-0.2302866042444709,-0.027274457495633914,,,-0.3421521815739027,-0.04100225855384124,inf,,-8.543667414322838,-9.550320228733993,-6.115462972560424,,24.49736466058609,7.581966599590924,4.384084800275934,,-1.1541358189935633,-0.7114500501830969,,,-0.9733454016033268,-120.83307965226787,-74.03778051181091,,-0.3203779847985516,0.5137254483090977,-0.803653822533084,,0.11022031823745415,-0.008429881926344307,3.259702485658527,,27.307692307692307,8.28410475328815,6.834622043103482,,-0.07628437986507519,0.30777379948424405,-1.8773883299540841,,0.25833924769339944,0.22634857164909708,-inf,,19.52027027027027,4.770385845689969,2.71284574495207,,,,,,-0.03448206449535007,-0.006780895024690703,,,-0.952948088753807,-16.587464037797094,,,0.21031659020206717,0.3622781428072884,,,1.125606569615528,-0.01858920741123519,0.5284698446137772,,1.2015195072523759,0.0026518396140178258,-0.19659832186871368,,-0.036638457156806914,0.017885648794246516,0.21421092696694846,,-0.17472924187725636,2.2649464955517766,1.7144998876318858,,-11.995824634655532,,,,-0.44644911994735303,,,,-0.44643040927647604,0.5971710000146356,,,0.337422812428815,,,,0.09467624188776158,0.07556241666496155,-0.15909087409047926,,-0.9230781034894538,-10.84314386834599,,,0.478629683125811,0.20112090354623144,,,-9.693589302137797,-9.255737507713528,,,-1.1084125814639656,-0.6819931551365848,,,-0.2596684251775434,-0.23125499707915775,,,-11.300401786043063,,,,-0.1480798875699495,0.04351620122773544,,,-0.09554553680454703,0.049040531738035874,,,-0.09756554999677958,0.07533621252837341,-0.36127494593995724,,-0.952948088753807,-16.587464037797094,,,-0.9511259218709446,-15.844673663078646,-7.829992494389979,,-0.9530531747313821,-18.66089734616758,-10.86158712965397,,18.222480856580137,4.1952724631927225,2.2662513591882893,,-0.9479775785726594,-14.925551787186635,-7.836374812963332,,-0.9511259218709446,-15.844673663078646,-7.829992494389979,,-0.6768986577316538,-0.0735166886032866,-2.0629619127506205,,0.21031659020206717,0.03603236782632505,,,-1.1706283103650938,-0.7451420764209636,,,0.01570075869458809,-0.29413964672854725,,,-0.6636347579357686,-0.13672433644090473,-2.928020500691267,,-0.0022258716224996533,0.0009057981788673786,,,0.1033897277302771,-0.00855236123795211,0.7721697383580691,,,,,,-0.8981188940860166,-0.6289179343516893,,,-1.081853267070472,-17.194146789874893,-9.969952656488653,,24.380138445987996,7.337171513215637,6.74815289728015,,-0.03231244731666194,0.00652301273166737,0.609723842359439,,25.22761693648992,7.642278677223637,4.934485976262938,,-0.035553555355535504,-0.07641467672421105,,,-9.683875485169569,-10.371569980877032,,,-1.1774330953938124,-0.70451357321641,,,0.040005250068506415,0.038038698263409186,0.6774725659523992,,,,,,2.04805941916101,0.3722127984327115,-17.233392482448693,,-0.04994261291811308,0.12160098947873932,,,0.198710884467046,-0.17853967903393472,-0.046665693811116335,,0.198710884467046,-0.17853967903393472,-0.046665693811116335,,-0.4440873688982513,-0.25748343470142393,-0.8024819944278526,,28.35123299472343,8.866766147661245,,,-0.4422191750679142,-0.2357960927517604,,,-8.845453715666466,-9.58498868519478,-6.107947267907024,,-8.845453715666466,-9.58498868519478,-6.107947267907024,,22.774990240853786,6.790426787698753,4.401689480696193,,-1.081853267070472,-17.194146789874893,-9.969952656488653,,-1.0083393013718123,-7.440844949636948,,,164.6483560545309,55.44606727515794,33.033109840137755,,,,,,,,,,0.17875650667788423,0.2933307362504594,-inf,,,,,,-1.0094985721367058,3.2049500279235965,1.3497216009273751,,,,,,-0.6587975800173962,0.47003317490437585,-0.14720686855154183,,0.0,0.031055777810330826,0.018633466686198495,,,,,,,,,
2012,42462000,33465000.0,8997000.0,0.2119,0.0,595000.0,2163000.0,2758000.0,36223000.0,385000.0,2956000.0,2163000.0,7220000.0,0.126,6239000,0.1469,-4138000,2101000,0.0495,-1000,234000,0.0055,0.32,0.32,734183,734183,1032000.0,0.0,1032000.0,1641000.0,907000.0,4700000.0,8280000.0,0.0,0.0,0.0,0.0,7994000.0,0.0,33795000.0,41789000.0,0.0,50069000.0,8438000.0,2072000.0,0.0,0.0,53000.0,10563000.0,44321000.0,0.0,0.0,188000.0,44509000.0,0.0,0.0,55072000.0,0.0,0.0,263000.0,-37686000.0,40694000.0,3271000.0,58343000.0,-8274000.0,50069000.0,234000,2163000.0,0.0,0.0,2984000.0,42000,0.0,477000,-2283000.0,-148000,5233000,-2819000.0,0.0,0.0,80000.0,0.0,-2739000.0,-1572000.0,0.0,0.0,0.0,-500000.0,-2072000.0,0.0,422000,1032000,610000,2414000,28.0,28.0,27.77,750.0,0.25,0.5,28.27,-0.00047596382674916705,0.0,-2571000.0,-543406.9490718702,50069000.0,6239000.0,5057000.0,11387000.0,3271000.0,3271000.0,3271000.0,0.0568508313315435,0.06613315549627653,0.0,0.050939663699307615,-0.060548254910272714,0.050939663699307615,0.1190947199849277,0.1469313739343413,0.26816918656681266,0.4420580221189293,0.06495219254863172,57.83571670823214,8.497881318417887,3.2880085755186377,-3.839642160060911,4.455292481574757,0.0,46393000.0,14.1831244267808,0.022244735197120256,9026000.0,0.19455521307093743,45361000.0,37367000.0,-2283000.0,0.7838682192558932,0.0937233740414655,0.1246376811594203,0.020611556052647348,3.2292876796086825,0.21096886296910264,1.7107577807848444,1.078008141626432,0.09769951718261857,-0.0455970760350716,0.8889532445225589,0.9265813177814616,0.9059697617288143,14.1831244267808,16.836441455212473,13.867624579639253,0.06532984481415646,15.30693977376949,16.836441455212473,6.2826869806094185,0.022244735197120256,0.20676568855316677,0.05446628009295819,7.627700831024931,0.06371650895609252,42420000,inf,48.662393162393165,0.07153775603790889,6241969.538315088,47780000.0,0.1306397977880931,39506000.0,0.1280058725256923,0.28823469852680605,0.8480696638638678,36.89636163175303,1011.0,41.145348837209305,0.17969202500549242,0.17969202500549242,-0.011373104836163044,0.1579253784235306,-0.013755048576719237,0.1010006191455791,0.1010006191455791,0.12466734982354526,0.07153775603790889,3.481198410272088,0.8897338403041825,0.0,0.0,0.05630230282210549,inf,0.005252751203339391,0.018115001298208474,0.0008388423974914617,1.0,0.0,0.0,0.17033239622953533,0.09208556149539482,0.05668973134669231,,0.1421891532134203,0.07149888067770738,inf,,0.28841472146641856,0.18734820693286813,-0.045691245305740626,,0.10077922077922086,0.08389354855468656,-0.12859586265395556,,,,,,0.04020979020979021,0.009044479848487922,inf,,-0.3761176809922123,-0.2408001509652453,0.08671758727391517,,-0.317157712305026,-0.20903849452872234,-0.03094011983826599,,0.08653788469614243,0.031832656907986236,2.538693484954549,,-0.20781893004115226,0.7783460709386635,inf,,-0.03932401689957754,-0.012868470492028106,inf,,-0.3761176809922123,-0.1935651595495096,-0.1024578293504919,,-0.3637645400070497,0.42758769466634466,0.6494142057603577,,-0.5903771131339401,0.09620304378259614,0.42506931065820186,,1.1192255434782608,8.992880663033867,5.0914674740679065,,0.8113440197287298,7.901463264792206,4.424583448867082,,-3.224731182795699,-0.9935341740556658,-0.8844421373083364,,-0.5626561199000832,-0.48081229694845345,-0.3208345157323417,,-0.6261329305135952,-0.4603688600174875,-0.32272795109035407,,-1.0005790387955993,0.5734489889212085,0.2257830561455993,,-0.9190031152647975,-1.1791936221936987,-0.6817599391920609,,-0.9309045226130653,-1.126478393156239,-0.6561216850548378,,-0.9185750636132316,-1.1797462378962156,-0.6822827075633542,,-0.9185750636132316,-1.1797462378962156,-0.6822827075633542,,0.0,0.0,0.0,,0.0,0.0,0.0,,0.6918032786885246,0.785997769889948,inf,,,,,,0.6918032786885246,-0.018455481320124163,-0.038218056078541895,,-0.024955436720142554,0.09419427191445522,,,inf,,,,-0.09178743961352653,-0.031114968346071265,,,0.1087305838243171,-0.11763118961912611,,,,,,,,,,,,,,,,,,,-0.25837276185174873,0.6593358022695264,inf,,,,,,0.02217046760631547,-0.03170012976539186,,,-0.046805501699322516,0.01913493481417905,,,,,,,-0.024167300083805965,-0.01420361934896297,-0.049852562018232516,,0.059917095842230816,-0.001533972253311829,,,-0.2562814070351759,inf,inf,,,,,,,,,,-0.9733400402414487,1.2275049025941742,,,-0.17055359246171964,0.016839006204847424,,,-0.018991124194869258,-0.01569414068038148,,,,,,,,,,,inf,,,,-0.014829898846809408,-0.014307065564361529,,,,,,,,,,,-0.04907276306247199,-0.02418874073168964,-0.02086919138715395,,,,,,,,,,8.068965517241379,2.117526930893604,2.8661123733494285,,0.05859550561797744,0.11292836902963847,,,0.054030252797347744,0.10264447842124332,1.8843260487548736,,0.07704972011853806,6.191774122836698,2.7823537530249904,,-0.04278846942626047,0.03699873899108482,-0.01913114701420384,,-0.14187927815805845,-inf,,,-0.024167300083805965,-0.01420361934896297,-0.049852562018232516,,-0.9190031152647975,-1.1791936221936987,-0.6817599391920609,,-0.3761176809922123,-0.1935651595495096,-0.1024578293504919,,,,,,,,,,-1.519317786286112,-12.17514588470909,,,-1.3818181818181818,-0.23741208659059124,-0.2858849294103457,,,,,,1.4090909090909092,0.11859466758139758,-14.457208997579167,,-0.5665464211125878,-3.9972930841631436,-inf,,-1.0502888209310228,6.245492394133994,2.281625344927078,,0.4728398536448073,0.2229117576342071,1.5966836083921934,,0.5899605188945289,0.30960707966018886,0.13643394315902227,,,,,,,,,,inf,,,,-1.0,-0.644794238324763,-0.3679908037122681,,0.5633561643835616,0.1798068440927553,-0.012624283303019967,,-0.08231173380035028,0.08661442552718879,-inf,,,,,,,,,,,,,,-inf,-inf,-inf,,0.2095738470519557,0.24321865464190306,-2.963209744246418,,,,,,3.795454545454546,0.3141822447281541,0.003381115943991131,,0.6918032786885246,0.785997769889948,0.27964352542669013,,0.1685823754789273,0.3657059553442887,0.005998316843456775,,0.35617977528089884,0.1502040949482474,-0.029286703256113357,,0.1914893617021276,0.18790138370589612,0.008028205136365263,,0.21739130434782616,0.1895163430393995,0.010422670825755653,,0.21744848750548007,0.18946201889087608,0.010420336411548603,,-0.16666666666666663,0.22718253968253965,0.23130952380952383,,inf,,,,1.0,0.3333333333333333,0.2,,0.22593235039028636,0.19055688051638864,0.011836491767616652,,-1.0013239897068344,0.3223058828845912,0.0434797424554787,,,,,,-0.007719027402547263,-0.04455507416095502,-inf,,1.8474054937738003,0.23513536677119942,0.06131705132430269,,-0.024167300083805965,-0.01420361934896297,-0.049852562018232516,,1.1192255434782608,9.21900211558193,5.339914314170589,,-0.3583301611470625,-3.825387429404897,-5.705243022883298,,-11.722222222222221,-4.490686166963815,,,0.07704972011853806,6.191774122836698,2.7823537530249904,,0.07704972011853806,6.191774122836698,2.7823537530249904,,0.07704972011853806,6.191774122836698,2.7823537530249904,,0.15879879908486583,0.05552597197141551,-0.020492747887987318,,-0.1926436628837429,-0.13522748100767182,inf,,,,,,-0.4669186967585005,-0.29390858737968123,0.15275261597854453,,-0.15213748180065045,-0.11950767421567932,-inf,,-0.4669186967585005,-0.2464697975003709,-0.1300467302897341,,-0.4517200062817984,-3.5804303783283413,-6.014689277206269,,0.8107894392275039,8.179745109089989,4.691836122248449,,-10.161689667624385,-3.9642397902377873,,,-0.6777868737018747,-1.5793479303043256,-72.8626523851142,,-0.416539873718877,-0.26578982391958983,0.01329995408915754,,0.17033239622953533,0.09208556149539482,0.05668973134669233,,1.1192255434782608,8.992880663033867,5.0914674740679065,,0.35617977528089884,0.1502040949482474,-0.029286703256113357,,0.5899605188945292,0.30960707966018886,0.13643394315902227,,0.07704972011853806,6.191774122836698,2.7823537530249904,,,,,,-0.03277389763369121,-0.014800469229968102,inf,,-0.1019670825782697,-16.184443440593828,inf,,0.7491290552948737,0.8004156728628181,,,-0.20748090262534025,0.18026230348443018,-0.08766069522148509,,-0.18062685091338015,0.20988040751858372,-0.2327236920513897,,-0.04210748600992509,0.027119929010818722,-0.36884492954523085,,0.02162620297462814,-0.01469239666412873,1.144190768916617,,-0.5665464211125878,-3.9972930841631436,,,0.3367115388623192,-0.025164088213943597,,,0.6577321783584209,0.9942238653800617,,,0.5258921358992634,-0.0033079489319346087,,,0.733702179516857,-0.026483632112474547,0.006276323842390963,,-0.22989032721071323,-10.45526184963121,,,-0.15001166940858368,0.010554206704068444,,,-0.3320642441980757,-3.9138706470321245,-5.819855353467732,,-13.92696203730001,-5.132723779837243,,,1.0396776251158157,-0.02962953920396853,,,-0.5558115864280446,-3.71267683748644,,,0.00956864966484372,0.007958969939902564,,,-0.008819747022849711,0.004893273473892974,inf,,-0.01838448939829518,0.051084505543367374,-0.34632508179011745,,-0.1019670825782697,-16.184443440593828,inf,,-0.11709996374831166,-15.442476843774138,-9.372450894892935,,-0.11063296698628633,-18.267155184131425,-11.745569899615573,,0.10372374302586573,5.767379431082117,2.4528345627606245,,-0.09397618170422462,-14.531274126412718,-8.826077277345226,,-0.11709996374831166,-15.442476843774138,-9.372450894892935,,0.5055629153406331,0.19113166615168398,-0.2074101147317581,,0.7491290552948737,0.013937040374175388,-0.028554768245230223,,-12.27554433791723,-4.671153129412976,,,0.38243374624705484,0.16667160202047104,,,0.494615274898486,0.09840449270288087,-0.11261661526242935,,-0.006772066272675459,0.0017244721887241428,,,0.1656408001758629,0.08998031435181601,0.06462790133182525,,,,,,-133.37820512820514,-44.95976138724061,,,-0.9247974506448151,-17.080824816715353,-10.210597945318465,,2.3102389288675886,8.444133352272504,4.76224104277082,,-0.009042641446822652,0.06779748975231688,-0.04627284287971993,,2.3404453786998674,8.760157339895505,4.982580588549238,,0.024161352206149234,-0.004072201819237582,,,-0.3734680209610387,-3.933551861328004,,,-11.469270490558396,-4.408355849628126,,,0.19931664139769567,0.10955437854333734,0.11257661359963626,,-1.0,,,,-4.065156275839259,-0.8617285106449412,-3.574054688558629,,-0.30823375804261954,-0.3198377623930337,-0.18868615792128032,,0.3203233726201935,0.20216644365926326,-0.012073873820594373,,0.3203233726201935,0.20216644365926326,-0.012073873820594373,,1.8733885158601415,0.22880741878784208,0.14140374770191386,,1.0692301451458115,9.550247159145837,,,1.780231345031908,0.2194423704614279,,,-0.3424386793883367,-3.666812025101447,-6.012175584215088,,-0.3424386793883367,-3.666812025101447,-6.012175584215088,,2.3922197208106235,7.925189333012401,4.4601389614046445,,-0.9247974506448151,-17.080824816715353,-10.210597945318465,,-10.955178504704644,-10.705020845082203,,,-0.9910687845729245,55.423129641747614,32.57605121715174,,,,,,,,,,0.629337199943266,0.3300762665011474,0.192558884431434,,,,,,8.293565913522098,2.2018158618068204,3.1893986723609835,,inf,,,,-1.3912742233899036,-0.1759769470765479,-0.21418454855046848,,0.0,0.11845039018952064,0.018633466686198495,,,,,,,,,
2013,46565000,38635000.0,7930000.0,0.1703,0.0,642000.0,2257000.0,2899000.0,41534000.0,0.0,2843000.0,2257000.0,6979000.0,0.1214,5031000,0.108,-3152000,1879000,0.0404,59000,495000,0.0106,0.67,0.67,734183,734183,668000.0,0.0,668000.0,1957000.0,918000.0,4279000.0,7822000.0,0.0,0.0,0.0,0.0,5160000.0,0.0,38345000.0,43505000.0,0.0,51327000.0,9176000.0,0.0,0.0,0.0,579000.0,9755000.0,45008000.0,0.0,0.0,531000.0,45539000.0,0.0,0.0,55294000.0,0.0,2092000.0,574000.0,0.0,916000.0,3582000.0,58876000.0,-7549000.0,51327000.0,495000,2257000.0,0.0,0.0,350000.0,-316000,0.0,738000,-1933000.0,2062000,5164000,-3359000.0,0.0,0.0,0.0,0.0,-3359000.0,-1385000.0,0.0,0.0,0.0,-784000.0,-2169000.0,0.0,-364000,668000,1032000,1805000,30.73,30.73,30.73,600.0,0.0,0.5,31.23,0.03139968068121341,0.0,-2843000.0,-948730.70782331,51327000.0,5031000.0,4722000.0,7579000.0,3582000.0,3582000.0,3582000.0,0.03876301943519811,0.08095838587641867,0.0,0.04846988081176849,-0.0610544400300655,0.04846988081176849,0.10140663588532159,0.10804252120691507,0.16276173091377644,0.5762273901808785,0.06225706002362289,63.42424164002708,6.852514972425131,2.4585151113550707,-4.575153606117276,4.8788925921738855,0.0,45008000.0,12.565047459519821,0.014841805901173125,5828000.0,0.12948809100604336,44340000.0,39180000.0,-1933000.0,0.8018452075858534,0.100871348026653,0.08540015341344924,0.013014592709490132,2.7233389168062536,0.1900559159896351,1.6609215617305664,0.7769349051768324,0.06847770374167093,-0.037660490580006624,0.887232840415376,0.8768874081867243,0.8638728154772342,12.565047459519821,15.436627582356225,12.3785594639866,0.06978783096615816,14.329145728643216,15.436627582356225,6.353345751540335,0.014841805901173125,0.1370673129091764,0.04010398151439744,7.922911591918613,0.06316654816921437,46881000,-inf,15.311111111111112,0.13819095477386933,4873028.206492815,49121000.0,0.0992045806578208,41572000.0,0.1135860675454633,0.18231020879438084,0.9072223196368383,42.08605664488017,-147.35759493670886,69.70808383233533,0.1544995811171508,0.1544995811171508,-0.019314157037179824,0.12101895506590975,-0.022821387179431107,0.0919983634344497,0.0919983634344497,0.0949408343852712,0.13819095477386933,2.115857063093244,0.8623693379790941,0.0,0.0,0.06544313908858886,inf,0.011183197927016969,0.01788532351394003,-0.006156603736824673,1.0,0.0,0.0,0.0966275728887005,0.12572676245189665,0.04833406466784056,,0.15448976542656512,0.12431265476663511,1.7863935026255973,,-0.11859508725130596,0.14982015416968233,-0.07986679432146815,,-0.19631901840490795,0.01905160438425198,-0.15272916710257972,,,,,,0.0789915966386554,0.021031925429129832,0.0002696913662537215,,0.04345815996301439,-0.2007678355681204,0.3048345943729573,,0.051124002900652554,-0.1705011798020805,0.19252131344586076,,0.1466195511139332,0.085516296547039,2.781254027881332,,-1.0,0.2640603566529493,0.2977768733324289,,-0.038227334235453325,-0.038060844868011756,-0.018939116925401622,,0.04345815996301439,-0.2007678355681204,-0.10771634117380464,,-0.03337950138504153,0.5281546486654143,0.31130626664839794,,-0.0365079365079366,0.12264229430441542,0.15136933301456226,,-0.1936207725597051,9.41109902620362,5.155583806156601,,-0.2648059904697073,8.296762676419673,4.486274572739286,,-0.23827936201063316,-1.6339310921942314,-0.8349704690746232,,-0.10566396953831514,-0.9433698968019169,-0.3970386250124295,,-0.1838383838383839,-0.9522038768525043,-0.3834115279894369,,-60.0,-21.154299702178267,-11.826500714505519,,1.1153846153846154,-0.8277565542236266,-0.5156729826703218,,0.9272727272727275,-0.8389799267104042,-0.4959443014628201,,1.09375,-0.8347707477001372,-0.5203954526613935,,1.09375,-0.8347707477001372,-0.5203954526613935,,0.0,0.0,0.0,,0.0,0.0,0.0,,-0.3527131782945736,0.16922415862429277,0.2872415932853634,,,,,,-0.3527131782945736,0.16922415862429277,0.07830275112263844,,0.1925655088360756,0.07918004734866768,0.11801212105623912,,0.012127894156560126,,,,-0.08957446808510638,-0.12642834410371873,,,-0.05531400966183575,-0.024275517360214976,,,,,,,,,,,,,,,,,,,-0.35451588691518643,0.2053398466062243,0.13660400725039942,,,,,,0.1346353010800414,0.036707715692661146,,,0.041063437746775566,0.03455973259430286,,,,,,,0.025125327048672874,0.022824058255932145,-0.02705257227574549,,0.08746148376392515,0.057628061036652044,0.04510124637695652,,-1.0,inf,inf,,,,,,,,,,9.924528301886792,4.823073682843529,2.5118802817685273,,-0.07649342042980212,0.11047036440221458,0.0456538704860989,,0.015500552785361332,-0.031351266197522265,inf,,,,,,,,,,1.8244680851063828,,,,0.02314138713518621,-0.027417246298227355,-0.007001454750669822,,,,,,,,,,0.00403108657757123,-0.014044128022126068,-0.00737930026979563,,,,,,inf,,,,1.1825095057034218,2.74711172093498,3.477809586990113,,-1.0,-0.27869634826809264,-inf,,-0.9774905391458201,-0.27571347724564405,1.6888279409257099,,0.09507795781106698,6.5641326493999586,2.8966570429999026,,0.009135628952916308,0.00638351961421572,0.0004709031091318705,,-0.08762388204012572,-0.08287609578664464,,,0.025125327048672874,0.022824058255932145,-0.02705257227574549,,1.1153846153846154,-0.8277565542236266,-0.5156729826703218,,0.04345815996301439,-0.2007678355681204,-0.10771634117380464,,,,,,,,,,-0.8827077747989276,-12.141671355610724,-7.887722991879147,,-8.523809523809524,-3.513796431677226,-1.7742924900495924,,,,,,0.5471698113207548,0.44690891327637994,-0.05822279650904434,,-0.15330705212439777,-4.238559369297506,-2.635131167016672,,-14.932432432432432,1.6057595822121822,0.3690608296931587,,-0.013185553219950297,0.17490075401851746,0.24611261345068264,,0.1915572898190847,0.34661901880233775,0.29211270473218104,,,,,,,,,,-1.0,,,,,,,,0.22635998539613,0.2081331107491778,0.11404849198632276,,-0.11895674300254455,-0.046424065526569414,-inf,,,,,,,,,,,,,,0.5680000000000001,-inf,-inf,,0.046814671814671804,0.3700948742542438,-2.7643137159891786,,,,,,-1.8625592417061612,0.4046818211642645,-0.20651054008954883,,-0.3527131782945736,0.16922415862429277,0.2872415932853634,,0.6918032786885246,0.785997769889948,0.27964352542669013,,-0.252278376139188,0.009205673092211875,0.2054445595188886,,0.09749999999999992,0.09289046667532837,0.033270241988243535,,0.09749999999999992,0.09450542600883176,0.03423921758834556,,0.10658984515664383,0.09760717126820562,0.03603314003370732,,-0.19999999999999996,-0.26805555555555555,0.0713095238095238,,-1.0,,,,0.0,0.3333333333333333,0.2,,0.10470463388751328,0.09991604736135377,0.0370413194382337,,-66.97072911122937,-22.571124730557585,-13.348480381475209,,,,,,0.1057954103461689,-0.015790721956347748,-0.01017317399107116,,0.7458935875658674,0.7104162716120914,0.3186007012908591,,0.025125327048672874,0.022824058255932145,-0.02705257227574549,,-0.1936207725597051,9.41109902620362,5.295709857725032,,-0.06624480917540043,-3.2665692692431585,-5.525148086144685,,-0.33441643979977165,-4.409254460012272,-2.8576176119197827,,0.09507795781106698,6.5641326493999586,2.8966570429999026,,0.09507795781106698,6.5641326493999586,2.8966570429999026,,0.09507795781106698,6.5641326493999586,2.8966570429999026,,-0.31816266310796104,-0.10911759043489515,0.1907047406038789,,0.2241724331598971,-0.07694891947077658,0.9025395954407992,,,,,,-0.048484475714603015,-0.2858517846823354,0.35133517112169477,,0.008360028221175098,-0.12468801927464875,-0.04512016521327542,,-0.048484475714603015,-0.2858517846823354,-0.12768198962692545,,-0.14852114436177077,-3.047969521655469,-5.85024036736911,,-0.264673579822403,8.347826839997063,4.658403131635575,,-0.3930632635408118,-3.9029629167195865,-2.5378206163428976,,0.3035107640821253,-0.4492071704076921,-72.57470301328468,,-0.04149409618452671,-0.25947065156731847,0.21662847500477786,,0.0966275728887005,0.12572676245189665,0.048334064667840584,,-0.1936207725597051,9.41109902620362,5.155583806156601,,-0.25227837613918813,0.009205673092211838,0.2054445595188886,,0.1915572898190847,0.34661901880233775,0.29211270473218104,,0.09507795781106698,6.5641326493999586,2.8966570429999026,,,,,,-0.029853641713189494,-0.03236986794741026,-0.016594044884190563,,-0.11408466277047535,-0.38966661136751735,-9.995688771748005,,-0.33279466940588687,0.208883658697018,0.30063376286217036,,-0.354309771770441,0.18793863173991557,-0.12351165932589736,,-0.33444039374657997,0.2288174208641386,-0.10142234516358133,,-0.022508322126937208,-0.0337514217645564,-0.0021917723508245502,,0.04851874648754251,-0.03486143080502857,1.3729968872235,,-0.15330705212439777,-4.238559369297506,,,0.022933686923836794,-0.028934631387065684,,,0.07626671636922788,0.09585616181705758,0.5051023789543112,,-0.3148127226130236,0.1828340752383516,,,-0.36857786591912656,0.15326685182849734,0.11836231271852302,,-0.15667503579728725,-0.4365478221658181,-6.583199393609194,,-0.09912812101817292,0.0764966308996848,0.07084458404238754,,-0.029131078411003708,-3.3515948749156252,-5.625681569149932,,-0.2792866072378256,-5.1048870753339335,-3.250445621989518,,-0.29909885210923437,0.160303449276346,0.0093627563538216,,-0.17405908766957878,-4.010090820046895,,,-0.001935314503640595,-0.046815517469582124,0.027636387768881887,,-0.05363146076992009,-0.05266558153243894,0.016934077484267562,,-0.04646617142193432,-0.05413873693900303,0.03223159535297815,,-0.11408466277047535,-0.38966661136751735,-9.995688771748005,,-0.08314190837653956,-0.38378926466526525,-9.546852572272158,,-0.10737708589536898,-0.39035440920434583,-11.24014041827688,,0.06823812554098851,6.13148090838233,2.5515558516290042,,-0.06387913322830574,-0.3686109645017299,-8.986902135298486,,-0.08314190837653956,-0.38378926466526525,-9.546852572272158,,0.01124658464586803,-0.05336305258171755,0.05925188683532827,,-0.33279466940588687,0.208883658697018,0.10488629787359241,,-0.33708869267285835,-4.594420446985061,-2.9696118519705963,,-0.263691563918969,0.04481431367422465,-0.15273535157151116,,0.038702456668586294,-0.04343900878956545,0.024628944448871627,,-0.00863137036049999,-0.005876436085225034,-0.002537208419314663,,0.10516265912305522,0.12473106234306508,0.04902927511701236,,,,,,-0.6853604988144375,-44.98722817370187,-27.19006388601493,,0.9317205686552419,-0.35831004968668173,-10.315103450322852,,-0.21931240186599732,8.823688324329863,4.820488213329701,,0.02806613645876932,-0.0044296507682384245,0.0077185066413897555,,-0.24062512084764875,9.109145731447379,5.0053312579046265,,0.0522958537943603,0.013634550214991345,-0.030557364834424727,,-0.11264955814691058,-3.3899976880925062,-6.320165504347808,,-0.3674938870087987,-4.338065824320336,-2.790061019443285,,0.06974976030090096,0.10302388392236768,0.07663649929776484,,0.14065601006742323,,,,-1.1457542976624222,-1.054283718113557,-0.8188544356407093,,0.6941911006304475,0.11200490988990497,0.1501520622048092,,-0.14019789630380974,0.12627878692780992,-0.07109871215708408,,-0.14019789630380974,0.12627878692780992,-0.07109871215708408,,0.6982308099162711,0.7091773189593872,0.35983380433442813,,-0.23369532956662442,9.728922603434205,5.4871666517125846,,0.6591280686610497,0.6657134128750145,0.34639422708753537,,-0.08913069827971887,-3.092341031111507,-5.837307086650479,,-0.08913069827971887,-3.092341031111507,-5.837307086650479,,-0.23844667814266607,8.309587761173914,4.505010681152844,,0.9317205686552419,-0.35831004968668173,-10.315103450322852,,-0.3922044038484235,-4.11857406997496,-6.7339835514927815,,-0.03075582953631728,54.54217714680721,33.06327544227291,,,,,,,,,,0.1623527956816444,0.3234821674342649,0.3343364408752577,,,,,,1.1290172509802763,2.804361530788556,3.8074866496546327,,-0.012678872084384452,,,,-8.3394045833113,-3.463158795572866,-1.6641158563976153,,0.0,0.0,0.018633466686198495,,,,,,,,,
2014,50963000,48764000.0,2199000.0,0.0431,0.0,651000.0,2375000.0,3026000.0,51790000.0,0.0,5557000.0,2375000.0,-2848000.0,-0.0597,-827000,-0.0162,-9953000,-10780000,-0.2115,-4053000,-6924000,-0.1359,-9.43,-9.43,734183,734183,1058000.0,0.0,1058000.0,3025000.0,653000.0,26450000.0,31186000.0,0.0,0.0,0.0,0.0,5297000.0,0.0,38669000.0,43966000.0,0.0,75152000.0,15863000.0,0.0,0.0,0.0,16792000.0,32655000.0,117282000.0,0.0,0.0,61000.0,117343000.0,0.0,0.0,149998000.0,0.0,2092000.0,-70732000.0,,,-68640000.0,81358000.0,-6206000.0,75152000.0,-6924000,2375000.0,0.0,0.0,464000.0,-7000,0.0,6687000,-1469000.0,5026000,941000,-3701000.0,0.0,-116000.0,0.0,0.0,-3817000.0,-51565000.0,0.0,0.0,0.0,54831000.0,3266000.0,0.0,390000,1058000,668000,-2760000,37.5,35.0,35.0,550.0,0.0,0.5,35.5,0.37597402597402596,0.0,-5557000.0,-6227712.337662337,75152000.0,-827000.0,-5223000.0,6065000.0,-68640000.0,-68640000.0,-68640000.0,-0.054156937385946666,0.296043656207367,0.0,0.04660243706218237,-0.10903989168612523,0.04660243706218237,-0.10248611737927515,-0.016227459137020978,0.1190079076977415,-3.6590084643289,0.059376410336911094,69.41457375068613,-1.1264221590529881,-3.7592807242880864,-5.040977521952974,-93.49167714316458,0.0,117282000.0,-1.708653846153846,0.009020992138606094,6355000.0,0.054185638034822056,116224000.0,110927000.0,-1469000.0,0.9550145460113306,0.032613688562241616,0.03392547938177387,0.014078134979774323,-0.475743006993007,0.4345193740685544,-0.9398956271369444,0.18572959730516,0.03239932629000153,-0.01954705130934639,1.5614088780072386,1.5605971896955504,1.546519054715776,-1.708653846153846,-2.185285547785548,-1.6932400932400933,-0.9133489461358314,-1.094871794871795,-2.185285547785548,-40.80898876404494,0.009020992138606094,0.040433872451632685,-0.02353302297027677,-52.66783707865169,0.047381524871676815,50970000,-inf,-0.8759387637203928,0.10087412587412588,-516069.48051948054,48703000.0,-0.010596256504106123,42497000.0,-0.12290279313833918,0.1427159564204532,0.678132318501171,74.67687595712098,-7280.428571428572,48.16918714555766,0.029260698318075366,0.029260698318075366,-0.12787122636515896,-0.01946019719038991,-0.14654475228045127,-0.06949914839259101,-0.06949914839259101,-0.006867009268142971,0.10087412587412588,-0.0883595571095571,0.09789062941808517,0.0,-0.0,0.04924685969767937,inf,-0.9411858633170108,0.008689056844794549,-9.314456035767511e-05,1.0,-0.0,-0.0,0.09444862020831102,0.12046952977551562,0.0934665755166392,2.0497749404521572,0.2621716060566843,0.18628350823222325,0.12623160270327433,inf,-0.7226986128625472,-0.18429299288247822,-0.055849815863049754,0.37782902798738943,-0.7469172049324722,-0.28081900085271977,-0.13831111553466408,0.6928984141116394,,,,,0.014018691588784993,0.0444066928124102,0.024028745554580833,inf,0.05228178998670807,-0.09345924368082996,-0.1253321005892027,,0.04380820972749233,-0.07407516655896036,-0.10643665419160442,-6.106699853521752,0.24693022583907154,0.16002922054971572,0.0978095495353927,,,,,,0.9546253957087583,0.29235801485790913,0.17555852999944413,,0.05228178998670807,-0.09345924368082996,-0.09699110573976126,,-1.4080813870181974,-0.6017418094700963,-0.031739560880840956,-0.03572348479033023,-1.4917627677100493,-0.7062159391173086,-0.24793231457403947,-1.5202054201903488,-1.1643808387994434,-0.07959202262696256,5.124128075548491,3.5012682922398333,-1.15,-0.20115399024699246,4.457916760781382,2.930892576182355,2.1576776649746194,-0.4351109599439042,-0.21224084384060235,0.9854496738064691,-6.737094199042043,-2.4684714294934804,-1.6570390118851435,-0.9348209361186492,-6.235148514851486,-2.348373276401155,-1.5600186957484663,-2.375830114047959,-69.69491525423729,-43.565164764344296,-25.59491365749473,-12.923563466558047,-14.987878787878788,-4.930499095919656,-3.482015007815053,-1.8274763088897366,-13.820754716981131,-4.60812883744049,-3.2545834338354247,-3.209459439024149,-15.074626865671641,-4.96648397642829,-3.5040231158720574,-1.8382385616338048,-15.074626865671641,-4.96648397642829,-3.5040231158720574,-1.8382385616338048,0.0,0.0,0.0,0.0,0.0,0.0,0.0,0.0,0.5838323353293413,0.3076408119077641,0.5178224933409223,,,,,,0.5838323353293413,0.3076408119077641,0.03515054261487904,0.3213610670915479,0.5457332652018396,0.23778111243925756,0.20417631795625618,,-0.28867102396514166,inf,,,5.181350782893199,1.6666629583981887,0.9996862819539757,,2.986959856814114,1.0134588103255318,0.5157504556589799,,,,,,,,,,,,,,,,,,0.026550387596899316,-0.19544608705667862,0.33000838149805845,,,,,,0.008449602294953618,0.05508512366043683,0.009596902815763886,,0.010596483162854886,0.0016181397367693122,0.02181294507043352,,,,,,0.46418064566407535,0.15504622420964742,0.08933902293317186,0.37402713521047104,0.7287489102005231,0.29204249660222636,0.16232169544090255,,,,,,,,,,,,,,28.001727115716754,12.3176384591207,8.321754025077214,,2.3475140953357254,0.7001556941480679,0.464307538704093,,1.6058034127266265,0.5341042804390396,0.3148443086941687,,,,,,,,,,-0.8851224105461394,inf,,,1.5767583829245262,0.5283566237376344,0.31139571467332555,,,,,,,,,,1.7127355590118278,0.555897960842309,0.328840084678866,0.810671442217654,,,,,0.0,,,,-124.22648083623693,-38.32500193776404,-23.338278107570538,-10.951620345922475,,,,,,,,,-20.162479061976548,-6.6634504613489804,-0.2984157471310776,-0.6588675387039407,0.38185338677899305,0.11606684876854963,0.10039704654103276,0.37955614701440155,-0.1779043581931382,-0.1358025061304408,-inf,,0.46418064566407535,0.15504622420964742,0.08933902293317186,0.37402713521047104,-14.987878787878788,-4.930499095919656,-3.482015007815053,-1.8274763088897366,0.05228178998670807,-0.09345924368082996,-0.09699110573976126,,,,,,,,,,0.3257142857142856,-0.6921037584569181,-7.416486228642384,,-0.9778481012658228,-3.6278252689645094,-2.042778776969424,-1.8201343919098014,,,,,8.060975609756097,3.3390787767225873,1.7927858847642093,-7.050957587678816,-0.24004138644593898,-0.3199649532276415,-2.4770455382119536,,1.437439379243453,-4.8484272913733335,1.0482968258426013,-0.6462118409290138,-0.8177769171185127,-0.11937420556455192,-0.03244543948716836,0.1504288529538448,0.10181601667162843,0.29444460846174736,0.24443890909425595,,,,,,-inf,,,,,,,,,,,,0.1363501041976778,0.3086887513257898,0.18042612437441474,,36.231046931407946,12.009926151535018,7.2743866929973935,,,,,,,,,,,,,,-70.9375,-inf,-inf,,-2.5057630244352236,-0.7497915018561988,-0.34585847773896855,,,,,,-2.071428571428571,-0.04617775589339542,-0.598288215790054,-2.0107183673267808,0.5838323353293413,0.3076408119077641,0.5178224933409223,1.1485146488083218,-0.3527131782945736,0.16922415862429277,0.2872415932853634,12.053464736473655,-2.5290858725761773,-0.8083948244781555,-0.4661503927741246,-1.7363278239915807,0.22030589000976253,0.16976508390396336,0.17630200822549016,0.07992055853023791,0.1389521640091116,0.15128115611897922,0.161000238625462,0.07312683367133985,0.1389521640091116,0.15433016555707849,0.16278561316767673,0.07501468480227338,-0.08333333333333337,-0.15,0.07964285714285713,0.043432539682539684,,,,,0.0,0.3333333333333333,0.2,inf,0.13672750560358637,0.15578816329379533,0.1626205562080531,0.07592733158081727,10.973816861104996,-18.99941207994374,-11.005998920294122,-5.567239089937749,,,,,0.9546253957087583,0.3509005928841266,0.1853511167144124,,5.564257155700894,2.7191854123468544,1.4031113687160723,-0.7818744475031599,0.46418064566407535,0.15504622420964742,0.08933902293317186,0.37402713521047104,-1.1643808387994434,-0.07959202262696256,5.259800947077328,3.0094910677536304,-2.1060991105463787,-0.8435580269562806,-2.729701241587294,-3.1599837648082696,-0.1997625016492941,-4.085467054557095,-2.8012474884681025,,-20.162479061976548,-6.6634504613489804,-0.2984157471310776,-0.6588675387039407,-20.162479061976548,-6.6634504613489804,-0.2984157471310776,-0.6588675387039407,-20.162479061976548,-6.6634504613489804,-0.2984157471310776,-0.6588675387039407,-2.3971289691837154,-0.8521642777356035,-0.509742743275486,-0.4062763468604941,2.6567386195084426,0.8960891299281989,0.4950457219290648,inf,,,,,-0.038527921222630934,-0.18464369789857815,-0.1937476318152555,,0.785945324081752,0.2140559568340922,0.08715646593117783,,-0.038527921222630934,-0.18464369789857815,-0.16528435788766932,,-2.0106450774599636,-0.8702954093678442,-2.580091471361352,-4.795881466847743,-1.1501951172163352,-0.20135975260374472,4.624873326046247,3.0286711955850616,-0.26882131917860763,-3.607858083447935,-2.5109207906865563,,-7.349938456032665,-2.5747381885508047,-2.3568942965727033,-37.8068977072236,-0.04627024927966017,-0.16810140639435464,-0.17702676344459128,0.9006159906946959,0.0944486202083108,0.12046952977551555,0.09346657551663914,2.0497749404521572,-1.1643808387994434,-0.07959202262696256,5.124128075548491,3.5012682922398333,-2.5290858725761773,-0.8083948244781555,-0.4661503927741246,-1.7363278239915807,0.10181601667162865,0.2944446084617475,0.24443890909425597,,-20.16247906197655,-6.663450461348982,-0.2984157471310783,-0.6588675387039411,,,,,1.6058034127266265,0.5143919577932486,0.3063096726647066,,-1.1359846711012058,-0.450678805483317,-9.960679931130633,,-0.3921903979425403,0.008047995982148856,0.33525239024800546,,0.09042553191489366,-0.15712171416029586,0.055380534119548644,0.2471394078310447,-0.5815396024929185,-0.36553561571762616,-0.05726775473674943,-0.20795984564964468,1.6211998195760038,0.5188613371463805,0.33601025689630454,0.2928048643996332,1.8312149055640634,0.6337866183420781,0.36713129241184395,1.0774269290908112,-0.24004138644593898,-0.3199649532276415,-2.4770455382119536,,0.1910210810969739,0.18355543562770996,0.027692500675795984,,-0.6766803537350945,0.01910618033085143,0.4764515917548636,,-0.6027468567002466,-0.1305558144713356,-0.1854966852218148,,0.08171921273484539,0.14894784211085862,-0.07326190990434096,-0.031598305027605154,-1.1746910764786214,-0.5204188131622073,-6.539430332233908,,1.286271236577826,0.3457104820503565,0.2437611471343717,,-1.5658880279437384,-0.6423611168509392,-2.6673262094902226,,-0.7609457419564802,-4.9890647954981056,-3.287680737741207,,-0.5268631317979566,0.07123854706954158,-0.18297012030381932,,-0.480966630856274,-0.40361243498463245,-2.3586112461970345,,0.7598637098196608,0.2558323483269546,0.1563610610271456,,0.7797007633199324,0.23908318517572089,0.14814982459433826,,0.7902161371537357,0.24178849211116873,0.17940069647238072,-0.10483814595225112,-1.1359846711012058,-0.450678805483317,-9.960679931130633,,-1.1415649588050754,-0.4472689436433088,-9.510427479700805,-3.87579596601051,-1.1367881374376638,-0.4515993967731064,-11.209126155145462,-5.5063863651201235,-14.08751015028303,-4.638516093905392,0.6565732537008614,-0.2530738160028076,-1.076408727750127,-0.41142134756088583,-8.946822048043318,-3.994169247142506,-1.1415649588050754,-0.4472689436433088,-9.510427479700805,-3.87579596601051,-7.423228069108473,-2.302139523040657,-1.3677172972015104,-1.8245655800862497,-0.3921903979425403,0.008047995982148856,-0.1366347892451802,,-0.7050071852037765,-4.4392134052646215,-3.0111110532231122,,-1.5868001650117545,-0.4893526608945562,-0.27009538457386206,,-7.647535627227369,-2.371405965220099,-1.462723938490028,-2.1194378915285577,-0.2498952967202146,-0.08843291111779668,-0.05067065010290843,,0.08722083573302619,0.11934143167731477,0.0924648875823059,0.031080934852369336,,,,,-1.057209353218313,-45.04025832674596,-27.324370802750916,,-0.2700381436745072,-0.08770500855469347,-10.116158405033064,-5.177048653722632,-1.1059032409933254,0.32834109533608863,4.801436882791637,3.545632519606188,-0.008509598745953917,0.00350463208866425,0.04458980139395321,0.3288420512797341,-1.1068121696986455,0.331002696051191,4.986606945828044,2.627394134241066,0.022250553256999872,0.0329025864191698,0.012465960318729485,,-2.082023489272985,-0.8560470227936449,-2.799065726280782,,-0.21718066495433697,-4.017981680840511,-2.761948420169503,,-0.2525180390484355,0.005516120883387043,0.0291789713764955,0.5411901989061937,0.7743851981011276,-0.028319597277149722,,,48.40653771226089,14.398542379586404,8.935119576532731,-4.7223913082402715,-0.30898707155089633,0.025656757012310554,-0.11486185161990996,,-0.8106098533957309,-0.21016145902644903,-0.06886168374435017,-0.008120942242697392,-0.8106098533957309,-0.21016145902644903,-0.06886168374435017,-0.008120942242697392,5.6205957691555675,2.730738364977327,1.4010497670870732,-0.03221113692902287,-1.1608028856288788,-0.1084226900165639,5.451248652448401,,5.421377943779505,2.6202457858241543,1.3477666247649676,,-1.7554389643258195,-0.729002780664625,-2.569001147581976,-3.5108349761517785,-1.7554389643258195,-0.729002780664625,-2.569001147581976,-3.5108349761517785,-1.0723293545143764,0.360481229384527,4.492958393276032,2.3698394464576946,-0.2700381436745072,-0.08770500855469347,-10.116158405033064,-5.177048653722632,-1.0417606456744206,-4.129714518075829,-6.70980551695389,,-0.8864864216444831,-0.636103678584575,33.07042933481241,16.13317815120188,,,,,,,,,-0.2474862852924118,0.18140123677749953,0.18101906197853496,,,,,,-85.16070872207703,-25.246041852524883,-15.485248777135258,-6.914158553608422,-0.5141794981778106,inf,,,-0.9848707884510177,-3.57184986505074,-1.9704412425983917,-2.046654204540286,0.0,0.0,0.07107023411371238,-0.011801096476826034,,,,,,,,
2015,56811000,47016000.0,9795000.0,0.1724,0.0,641000.0,2705000.0,3346000.0,50362000.0,0.0,8093000.0,2705000.0,7811000.0,0.1391,6449000,0.1135,-9436000,-2987000,-0.0526,-1105000,-1791000,-0.0315,-2.44,-2.44,734183,734183,1077000.0,0.0,1077000.0,7852000.0,256000.0,11020000.0,20205000.0,0.0,0.0,0.0,0.0,5003000.0,0.0,38841000.0,43844000.0,0.0,64049000.0,14622000.0,0.0,0.0,,,14622000.0,126155000.0,0.0,0.0,0.0,126155000.0,0.0,0.0,140777000.0,0.0,2092000.0,-72523000.0,,,-70431000.0,70346000.0,-6297000.0,64049000.0,-1791000,2705000.0,0.0,0.0,7052000.0,-597000,0.0,-1241000,5583000.0,-7829000,137000,-5094000.0,0.0,-25000.0,0.0,0.0,-5119000.0,0.0,0.0,0.0,0.0,5001000.0,5001000.0,0.0,19000,1077000,1058000,-4957000,42.5,50.0,50.0,2500.0,0.0,0.5,50.5,0.3699363910277871,,-8093000.0,-10056104.787412118,64049000.0,6449000.0,5106000.0,17311000.0,-70431000.0,-70431000.0,-70431000.0,-0.08725422893453733,0.06544155181214906,0.0,0.047614018411927264,-0.14245480628751475,0.047614018411927264,0.08987696044780061,0.11351674851701254,0.30471211561141326,0.5188401302527523,0.05889704458643573,77.37989029982988,8.783913547439807,-6.7517226631507405,-6.9383246411317065,-95.93112343925152,0.0,126155000.0,-1.7911856994789226,0.008537117038563672,6080000.0,0.04819468114620903,125078000.0,120075000.0,5583000.0,1.3818219121871154,0.11448502256873205,0.05330363771343727,0.01681525082358819,-0.20760744558504068,0.22829396243501068,0.6309156060793278,1.183900971139379,0.07365613459171112,0.08716763727770925,1.9696638511139908,1.9696638511139908,1.9528486002904026,-1.7911856994789226,-1.9987931450639633,-1.7758941375246695,-1.0996424612406126,-0.9093864917436925,-1.9987931450639633,16.01305850723339,0.008537117038563672,0.12296753020734921,-0.0392929332963418,18.02291639994879,0.0641512425191233,57408000,,-9.665549972082635,0.025429143416961283,4063280.214261801,55724000.0,0.07291795661226404,49427000.0,0.10330386226151698,0.350233677949299,0.886992771159581,183.65625,-95.1608040201005,52.749303621169915,0.15292978813096222,0.15292978813096222,-0.18046272319668577,0.13047524632285998,-0.20345367486216276,0.0797202142109947,0.0797202142109947,0.06344018195852864,0.025429143416961283,-0.24578665644389544,0.024695613805275567,0.0,-0.0,0.07953285765585723,inf,-1.1323049540195789,0.0039969398429327545,-0.009320988618089275,1.0,-0.0,0.0,0.11474991660616518,0.10194203656772556,0.11727576483403324,1.960174808930757,-0.035846115987203664,0.12693841849868193,0.1198526908738772,inf,3.454297407912688,0.8710012359329449,0.6362118515118376,0.6357866038851528,3.0,0.6855879255542066,0.46204752164405677,0.9996635266095181,,,,,-0.015360983102918557,0.025883101708173945,0.012350696954651186,inf,0.1389473684210527,0.07822910612359173,-0.08221486965932008,,0.1057501652346331,0.06689412595425932,-0.07238903288882322,-6.090762756728489,-0.027572890519405258,0.1219922954778665,0.09518124499215666,-inf,,,,,0.4563613460500271,0.457586469174444,0.25936084143095,,0.1389473684210527,0.07822910612359173,-0.08221486965932008,,-3.742626404494382,-1.7280290976325403,-0.7132487691032672,-0.5441636394735088,-3.3299832495812396,-1.6194179845997418,-0.8907638268756084,-1.869674164447726,-8.798065296251512,-3.3853556358702197,3.6541701887119813,2.520386639432665,-8.006172839506174,-3.140326276658627,3.1468230379505697,2.1302752922317376,-0.05194413744599613,0.62248472183933,-0.5592119498108141,0.9551196480925949,-0.7229128014842301,-2.521890323354863,-2.0580233381864046,-1.1412897305008127,-0.7513002364066194,-2.3900957116988297,-1.9686120763631236,-2.4674305569878747,-0.7273624475697015,-43.474092567269,-26.777035361668357,-13.149713823122545,-0.7413344887348354,-4.87127622040967,-3.6424965878569004,-2.023648801405899,-0.7682119205298013,-4.553897970079402,-3.421181283528429,-3.2967021767445766,-0.7412513255567339,-4.907376063742792,-3.6640380868657574,-2.0345859164117006,-0.7412513255567339,-4.907376063742792,-3.6640380868657574,-2.0345859164117006,0.0,0.0,0.0,0.0,0.0,0.0,0.0,0.0,0.017958412098298737,0.08302585637768882,0.22189264466010367,,,,,,0.017958412098298737,0.08302585637768882,0.22189264466010367,0.29342217584366326,1.595702479338843,0.7780004177922528,0.47579517731733717,,-0.6079632465543645,-0.29483545878764866,,,-0.5833648393194707,1.5028038251628741,0.8437401822525145,,-0.35211312768549985,0.8598442398222593,0.5124040354095938,,,,,,,,,,,,,,,,,,-0.05550311497073812,-0.12782287142967508,0.11741336248896683,,,,,,0.004448007447826363,0.04917763694094046,0.02460415136415268,,-0.002774871491607156,0.016295016472674433,0.022300161890831262,,,,,,-0.14774057909303806,0.11385513120657005,0.07698244826776675,0.3233412649761723,-0.0782323646220765,0.24599267644745726,0.16468014573768056,,,,,,,,,,,,,,,,,,-0.5522278364722095,0.5729309461445712,0.425339470414032,,0.07565525826640074,0.5656530745927962,0.3174809744800921,,,,,,,,,,-1.0,-0.020218108479918822,,,0.07509608583383764,0.5583319519645167,0.31392054597273633,,,,,,,,,,-0.06147415298870651,0.5517641642002308,0.32182580439134856,0.7685853746504746,,,,,0.0,inf,,,0.025320929706497797,-41.00621680027567,-23.1919649487451,-11.009210293491213,,,,,,,,,0.02609265734265742,-6.680436148940941,-0.08879769128680266,-0.6921351973006402,-0.13535239312667469,0.08521220753507823,0.053130310498993104,0.3301090953767391,0.014663229133097033,-0.0836216703667223,-0.08237388328399502,,-0.14774057909303806,0.11385513120657005,0.07698244826776675,0.3233412649761723,-0.7413344887348354,-4.87127622040967,-3.6424965878569004,-2.023648801405899,0.1389473684210527,0.07822910612359173,-0.08221486965932008,,,,,,,,,,14.198275862068966,4.547094124328108,-4.380204783809783,,84.28571428571429,24.928018886879652,14.553295377883362,6.677094613989382,,,,,-1.1855839688948706,2.474187150727327,1.6432236761380732,-7.1062035830332775,-4.800544588155208,-1.7312976755751814,-3.551252816498733,,-2.557699960206924,-5.350897671131968,0.739403633134615,-0.8844040960756908,-0.8544102019128587,-0.5617908907504406,-0.22949697139516384,0.15102091882978627,0.37638476087543915,0.22325268912205076,0.3036115667908162,,,,,,-0.7844827586206897,,,,,,,,,,,,0.3411055802986638,0.23460522329749053,0.220371003348775,,-1.0,11.7040300628018,7.018354946965647,,,,,,,,,,,,,,-0.9087924714121574,-23.759430823804053,-inf,,0.5312308634415186,-0.6425724963930111,-0.17284950764619472,,,,,,-0.9512820512820512,-1.6284232881389278,-0.36173303184356576,-2.0067310266251503,0.017958412098298737,0.08302585637768882,0.22189264466010367,1.1596236995208318,0.5838323353293413,0.3076408119077641,0.5178224933409223,12.203471125496362,0.7960144927536232,-0.6617832519872474,-0.3410908721091837,-1.570693288648991,0.1333333333333333,0.15037974111436525,0.12646212467381618,0.09117488978456917,0.4285714285714286,0.22167453086018005,0.1702079741214071,0.11473657528108143,0.4285714285714286,0.224704479245728,0.17206902127703141,0.11562796652478458,3.545454545454546,1.0873737373737375,0.5315909090909092,0.3779779942279943,,,,,0.0,0.0,0.2,0.1,0.42253521126760574,0.2213224502529018,0.17180217179105067,0.11487856650944069,-0.016058649079806364,-18.67099029973473,-11.351123195929514,-5.57705949142783,,,,,0.4563613460500271,0.5055940507016514,0.2727229151779484,,0.6147349527686796,2.308295232011814,1.6620481846611697,-0.6343678661590647,-0.14774057909303806,0.11385513120657005,0.07698244826776675,0.3233412649761723,-8.798065296251512,-3.3853556358702197,3.6541701887119813,2.0286094149464624,-1.977599080987938,-1.3833143335699056,-2.7766811998527587,-3.491921187140804,1.8542456718878815,0.4400222434796053,-2.3146560419596462,,0.02609265734265742,-6.680436148940941,-0.08879769128680266,-0.6921351973006402,0.02609265734265742,-6.680436148940941,-0.08879769128680266,-0.6921351973006402,0.02609265734265742,-6.680436148940941,-0.08879769128680266,-0.6921351973006402,0.6111366917358065,-0.7013849801852899,-0.42266900975051885,-0.2521087949945873,-0.7789462789018191,0.7006549245888403,0.3293891164388588,inf,,,,,0.02170661908507343,-0.02176859261738684,-0.17487533123691273,,0.30644669656840273,0.3669173496237766,0.1436655925652417,,0.02170661908507343,-0.02176859261738684,-0.17487533123691273,,-1.8769671712236766,-1.3453777976818035,-2.6063041627300096,-5.000040882352624,-7.995349521974014,-3.1367394063375844,3.179587176160168,2.2291362433876603,1.5604358693989209,0.29951709555983386,-2.0834548399876893,,-1.1417980131259173,-2.729408568358819,-1.9678715960763316,-37.868143459924184,-0.008073336662748232,-0.031945894042311705,-0.16655110812887275,0.9527427056404246,0.1147499166061654,0.10194203656772556,0.11727576483403324,1.960174808930757,-8.798065296251512,-3.3853556358702197,3.6541701887119813,2.5203866394326653,0.7960144927536232,-0.6617832519872474,-0.34109087210918376,-1.5706932886489913,0.37638476087543893,0.22325268912205076,0.3036115667908162,,0.02609265734265742,-6.680436148940942,-0.08879769128680337,-0.6921351973006405,,,,,0.07565525826640074,0.5505350097599458,0.3168698134301593,,0.04830226643673585,-0.4005890224783151,-0.4513364477534044,,-0.053638789681640264,-0.25954128567668916,0.03616435769337469,,-0.04327301337529499,-0.10238575107694743,0.12219368275186908,0.21307737403580074,-0.1105635571692074,-0.3421811844695686,-0.0011301794139420007,-0.21901620136656544,0.0761804790748899,0.5582906588413188,0.3192252066714449,0.27068817984940774,0.08246865055396801,0.654067434201858,0.36181985274058914,1.0559390616884934,-4.800544588155208,-1.7312976755751814,-3.551252816498733,,0.44691190093215716,0.22028888965098928,0.1102258175735868,,2.510336537072249,0.6366409665687941,0.4242449337576654,,0.5711977747932464,-0.11545393484000795,0.10339062876161091,,0.1944231851552929,-0.030811822676329426,0.14718859067512607,-0.007611068920579311,-0.5636142990366806,-0.6316601371041964,-0.6095897684025513,,-0.47460579191805474,0.23751244121386608,0.20823106747176512,,-1.671261348455452,-1.088760151603398,-2.6583868002292137,,5.374325838838652,1.4446978298814486,-2.140256225823926,,1.2733847590664715,0.1491409250530935,0.24548639501951058,,-5.459375273447519,-2.038133663991124,-3.594122872888896,,0.26146576906094654,0.3397980547923223,0.17617658529437222,,0.26212187495880546,0.32939705916960593,0.17676517873628422,,0.26273814366244785,0.33549603646474974,0.1781076139998349,-0.07401941399450977,0.04830226643673585,-0.4005890224783151,-0.4513364477534044,,-0.08534006135288186,-0.4366823095114989,-0.4756545628307506,-3.8843754014470924,0.048814131329960375,-0.3984503640010241,-0.45180744674414813,-5.4969845436076366,0.20396751525574763,-4.605101503162098,0.9021800180239417,-0.2326513948952938,-0.16941280613573761,-0.4365668890380568,-0.4703308854782109,-4.011136203928985,-0.08534006135288186,-0.4366823095114989,-0.4756545628307506,-3.8843754014470924,-1.3923904755351795,-2.9347906533325947,-1.7951415404777609,-1.919204793997423,-0.053638789681640264,-0.25954128567668916,0.03616435769337469,,2.0412009226779833,0.3330350149337828,-2.4894135206961954,,0.6696934068338982,-0.39359944069894176,-0.15653276343103645,,-1.3421996687092772,-2.9836776130893536,-1.8240104644610688,-2.2117072628067014,0.353929462862663,0.031800931927316145,0.017280971577354663,,0.12630959387875218,0.10623102957827786,0.11754472332819473,0.06643329674620527,,,,,10.0345042055565,2.7639781178412495,-25.19687793375348,,-0.7479121311178188,-0.028743235379028082,-0.4185760847704742,-5.315251752065082,-8.873513872922041,-3.399576505260455,3.298329571814844,2.5676286343670394,0.14415949736155875,0.054572011691458054,0.024472189262177913,0.30734618869089503,-7.881482774978863,-3.0763066885083856,3.6678284499329257,1.798969235686099,0.16307033437654428,0.07920558047596815,0.04524490765570364,,-1.8405330718988488,-1.3450687064395817,-2.8185099250898706,,1.4540611066465554,0.28979551822780664,-2.3554634062537576,,0.3079936569312016,0.04174179272788903,0.07290945392997383,0.5240442758548727,1.4593456494545154,0.7914622858743554,,,-0.9869292304585542,15.424618061379972,8.851351465492334,-5.3626272456366495,0.09508394778952911,0.16009599228969343,0.024422321181669537,,4.226457224928637,1.0918831584096989,0.7589367464632673,0.376588156724598,4.226457224928637,1.0918831584096989,0.7589367464632673,0.376588156724598,0.41128483965065343,2.2433704729074972,1.6318825131368762,0.0986408937286766,-7.704723752095019,-3.0330739890968403,4.064248234515743,,0.38833818131407094,2.1562813979182085,1.5613712727437237,,-2.147067497297468,-1.3305457199676687,-2.6359059109915615,-3.7978428012831023,-2.147067497297468,-1.3305457199676687,-2.6359059109915615,-3.7978428012831023,-10.238400514884498,-3.84972551584718,2.723606682824574,1.305722773912163,-0.7479121311178188,-0.028743235379028082,-0.4185760847704742,-5.315251752065082,1.7816646493502035,0.11589986660911981,-2.3231636412498196,,-0.7477223923057841,-0.5549882144955282,32.39846452529427,16.019737279661392,,,,,,,,,0.6149833338430106,0.17661661474408108,0.2675887101706787,,,,,,0.20306200735847124,-27.94287648791276,-15.308912424470577,-6.911665542028277,-0.5400030274485721,-0.3556204659035891,,,99.07013380380646,29.915286144014715,17.53915732572737,7.9372983232653835,0.0,0.0,0.0,-0.005267702866535473,,,,,,,,
2016,58566000,47246000.0,11320000.0,0.1933,0.0,712000.0,2855000.0,3567000.0,50813000.0,0.0,7911000.0,2855000.0,2870000.0,0.0553,2357000,0.0402,-10253000,-7896000,-0.1348,-2737000,-4792000,-0.0818,-6.53,-6.53,734183,734183,3378000.0,0.0,3378000.0,3218000.0,248000.0,13852000.0,20696000.0,0.0,0.0,0.0,0.0,359000.0,0.0,42755000.0,43114000.0,0.0,63810000.0,17181000.0,0.0,0.0,0.0,291000.0,17472000.0,128246000.0,0.0,0.0,29000.0,128275000.0,0.0,0.0,145747000.0,0.0,2092000.0,-77365000.0,,,-75273000.0,70474000.0,-6664000.0,63810000.0,-4792000,2855000.0,0.0,0.0,-2359000.0,3573000,0.0,2559000,3224000.0,14673000,10377000,-4231000.0,0.0,0.0,0.0,0.0,-4231000.0,-3484000.0,0.0,0.0,0.0,-361000.0,-3845000.0,0.0,2301000,3378000,1077000,6146000,53.75,53.75,53.75,1600.0,0.0,0.5,54.25,0.3466312056737589,0.0,-7911000.0,977199.4680851065,63810000.0,7753000.0,15000.0,5590000.0,-75273000.0,-75273000.0,-75273000.0,0.10494143359628454,0.06289752650176679,0.0,0.04874842058532254,-0.13507837311750845,0.04874842058532254,0.00025612129904722876,0.13238056210087765,0.09544787077826726,1.5133644463300806,0.060905644913431,79.77030249951306,3.2103712562126883,8.37120990270818,-5.762868385674961,-102.52620940555693,0.0,128246000.0,-1.7037450347402123,0.026340002807105096,3737000.0,0.029139310387848352,124868000.0,124509000.0,3224000.0,1.1845238095238095,-0.011160714285714286,0.16321994588326247,0.052938410907381286,-0.23211510103224264,0.27381288199341797,0.0018960940462646946,0.31994047619047616,0.1933379120879121,0.050524996082118794,2.0102648487697854,2.009810374549444,1.9568719636420624,-1.7037450347402123,-1.9362454000770528,-1.6588683857425637,-1.1796426892336624,-0.8477143198756526,-1.9362454000770528,43.50801393728223,0.026340002807105096,0.03835413421888615,0.047923521981192395,50.78292682926829,0.061686134460334045,54993000,inf,-1.1665275459098496,0.0636616050908028,1539990.2482269504,53002000.0,0.02905532335057074,46338000.0,0.00032370840347015407,0.12063533169321075,0.9178185237423602,190.50806451612902,16.391267842149453,17.337477797513323,0.17740166118163297,0.17740166118163297,0.01843703007594254,0.16731408347360696,0.021088511979047573,0.00023507287259050304,0.00023507287259050304,0.024133995427471407,0.0636616050908028,-0.0742630159552562,0.061940153816325214,0.0,-0.0,0.06630622159536123,inf,-1.212427519197618,0.0038865381601629837,0.05599435825105783,1.0,0.0,0.0,0.030891904736758624,0.08003014718374495,0.10141008213389413,2.057346407353001,0.004891951676025075,0.07707248058183525,0.10557927207709823,inf,0.15569167942827966,0.9624301581594735,0.6114220217387066,0.686265558596707,0.12122969837587005,0.7914374978144659,0.4557545391635422,0.011842251126515723,,,,,0.11076443057722307,0.03647404635436317,0.04572470518230702,inf,0.055452865064695045,0.08222734115748527,-0.01719549951134842,,0.06604901374775851,0.07186912956996132,-0.010085264138897898,-6.077590058743544,0.008955164608236421,0.07610416664263424,0.09229398714759567,2.012662436217075,,,,,-0.022488570369455063,0.4628327237964434,0.2621893640508599,,0.055452865064695045,0.08222734115748527,-0.01719549951134842,,-0.6325694533350403,-1.9277590816158732,-1.2360842572479422,-0.4299210351763157,-0.6024442846872753,-1.8080634339928547,-1.2102150703240881,-0.5203143517624653,-0.6345169793766475,-3.532321038142534,-1.9342716687018089,2.4937993482746617,-0.6458149779735682,-3.2673292724932477,-1.851089957644144,1.0987837944343808,0.08658329800763043,0.7307722751787512,-0.2541387438540157,0.3968792926652064,1.6434549715433544,-1.9388506763276396,-1.2969744236842635,-0.7994446837157804,1.5627376425855513,-1.8079037028908511,-1.2467364846049065,-0.9015525515753311,1.476923076923077,-22.981784874961303,-25.989186732735902,-12.825472462073952,1.675600223338917,-4.684537684424902,-2.7714463106309775,-1.6779047071786077,1.596825396825397,-4.330713746895179,-2.5991546072051745,-1.7157895204130433,1.6762295081967213,-4.713216227677218,-2.792894749328977,-1.6887811474102101,1.6762295081967213,-4.713216227677218,-2.792894749328977,-1.6887811474102101,0.0,0.0,0.0,0.0,0.0,0.0,0.0,0.0,2.136490250696379,0.9127603327080064,0.6154742197035941,,,,,,2.136490250696379,0.9127603327080064,0.6154742197035941,0.5613717510135532,-0.5901681100356597,0.5170892115016743,0.3437755413241912,,-0.03125,-0.30929475683983537,inf,,0.2569872958257713,1.6183244131331664,0.9347222663401734,,0.02430091561494674,0.8863825482478536,0.5425128437812085,,,,,,,,,,,,,,,,,,-0.9282430541674995,-0.3190652605137794,-0.3140168860616547,,,,,,0.10076980510285516,0.03788913828187838,0.0540946367063984,,-0.016649940698841292,-0.0029427763425311873,-0.0029140785960281024,,,,,,-0.00373151805648797,0.1042361828381831,0.06273331509588324,0.37608842198459175,0.1750102585145672,0.27517560136433794,0.19458107673983396,,,,,,,,,,,,,,,,,,0.19491177677472304,0.6633993452127463,0.3486302045493434,,0.01657484840077683,0.566011173131268,0.3389085895968592,,,,,,,,,,inf,inf,inf,,0.016804724347033506,0.5562197310351324,0.3353941362787548,,,,,,,,,,0.0353040624533838,0.5621884894921684,0.32830475839832085,0.8432842179216097,,,,,0.0,0.0,,,0.066765026267529,-41.3781316267543,-22.97658397146362,-10.960370187665358,,,,,,,,,0.06874813647399591,-6.689212756053298,-3.9791021180460575,-0.6556106549901918,0.00181957751684525,0.08277352372305453,0.04293354613916389,0.3834113619424918,0.05828172145466093,-0.034986469201793415,-0.06689251356071288,,-0.00373151805648797,0.1042361828381831,0.06273331509588324,0.37608842198459175,1.675600223338917,-4.684537684424902,-2.7714463106309775,-1.6779047071786077,0.055452865064695045,0.08222734115748527,-0.01719549951134842,,,,,,,,,,-1.3345150311968235,4.396491705528809,2.1574899111002774,,-6.984924623115578,25.4409805204443,13.283462771141041,6.3505325864604325,,,,,-3.06204673650282,1.271114968119469,1.1539211249540142,-7.029342814662894,-0.4225326885187175,-1.8210395543732878,-1.23659442727137,,-2.8741857197598675,-1.3314821002411128,-3.995433510817359,-1.0050552964504693,74.74452554744525,24.35744614280463,14.70639854576775,7.70325125135209,-0.16941499803690618,0.1029285931700538,0.21806071764475501,,,,,,-1.0,-inf,,,,,,,,,,,-0.17347138112912674,0.10132810112240494,0.21874009062938127,,-inf,-inf,-inf,,,,,,,,,,,,,,-1.0721855628874226,-24.306159344766527,-inf,,-1.7688462307538493,-1.2477927972491847,-0.6973979745761854,,,,,,120.10526315789474,39.02751751172804,23.8030895677865,9.337128622497655,2.136490250696379,0.9127603327080064,0.6154742197035941,1.4554155817333265,0.017958412098298737,0.08302585637768882,0.22189264466010367,12.214944386061031,-2.239862820254186,-1.32431140002558,-0.7738065601870059,-1.716901792896632,0.2647058823529411,0.20611503523201233,0.1814668934796329,0.07691228046385515,0.07499999999999996,0.21417453086018004,0.19148297938567324,0.07849940895664612,0.07499999999999996,0.21417453086018004,0.19331238504853282,0.0794012584502504,-0.36,1.034040404040404,0.5470909090909092,0.33086688311688317,,,,,0.0,0.0,0.2,0.1,0.07425742574257432,0.21117338087125548,0.19283142537831321,0.07902562055910792,-0.06299781778505176,3.6315867980800465,-11.415458541339214,-5.582132819273449,,,,,-0.022488570369455063,0.4628327237964434,0.2973149108665904,,-1.0971747499397908,1.6939391195099276,1.53502328797389,-0.666307563375266,-0.00373151805648797,0.1042361828381831,0.06273331509588324,0.37608842198459175,0.2022018917661652,-3.2534147477615964,-1.766927894473247,2.0856940109027398,-0.9970622796709753,-1.693586823735097,-1.101067088305551,-3.4141278654772043,-0.6770839350701866,0.32579974505613357,-2.215847885370718,,0.06874813647399591,-6.689212756053298,-3.9791021180460575,-0.6556106549901918,0.06874813647399591,-6.689212756053298,-3.9791021180460575,-0.6556106549901918,0.06874813647399591,-6.689212756053298,-3.9791021180460575,-0.6556106549901918,-2.2027088529430143,-1.329567043463641,-0.8296129988828037,-0.7479078010021947,-0.03887477053852462,0.6129725233560329,0.3740892680688506,inf,,,,,0.02382496187532679,0.0023345532459230953,-0.10167990254706685,,-0.05178086554074235,0.3468703850364708,0.1793667403059874,,0.02382496187532679,0.0023345532459230953,-0.10167990254706685,,-0.9971503119623635,-1.6282541868820013,-1.0970007422579147,-3.6901092032464127,0.1661764790685316,-2.993122720040606,-1.6866504601433434,1.2788403110476,-0.6867604998680525,0.2016180167840869,-1.9899797761625873,,1.9168222696899853,-2.1916380664895323,-1.3898380618176691,-37.7244478101364,0.03410358433261451,-0.0067466672032646295,-0.09565479430263953,-0.5227358248152026,0.030891904736758624,0.08003014718374495,0.10141008213389413,2.057346407353001,-0.6345169793766475,-3.532321038142534,-1.9342716687018089,2.4937993482746617,-2.239862820254186,-1.32431140002558,-0.7738065601870059,-1.7169017928966324,-0.16941499803690607,0.10292859317005383,0.2180607176447551,,0.06874813647399591,-6.689212756053299,-3.9791021180460584,-0.6556106549901921,,,,,0.01657484840077683,0.566011173131268,0.32708119600938473,,-0.048817196767564575,-0.37883320047734487,-0.27051026935615596,,2.085351025190662,0.5465072791888271,0.41117124469109373,,-0.38536184210526314,-0.11273644118855482,-0.17999999959228913,0.22884173992552634,-0.39538327270082085,-0.3624954774543156,-0.32051073540458136,-0.2585545286366475,-0.0016789523337437107,0.5652337821057166,0.32621710763605755,0.3248208347162853,0.03692692067457837,0.6502034922642033,0.40415108525095605,1.1139323038562032,-0.4225326885187175,-1.8210395543732878,-1.23659442727137,,-0.14278113621098032,0.16505061527271692,0.17095941432086134,,-1.0974862391193037,0.24538998140595028,0.29403376778909995,,2.0620789290355788,0.6768432823761928,0.4483218520829636,,2.1482379574808395,0.8081267851236592,0.5579009337937417,0.209730322947118,0.11804805640828064,-0.5400857730356737,-0.4013645364230044,,0.199387312186871,0.33701758561554734,0.1523825932839771,,-0.9969946946501331,-1.411381357016441,-0.9190678787316806,,-0.7297574003317462,1.2945408988501417,-2.0645251895974823,,1.6248718203801769,0.7904644825495639,0.6223944441310546,,-0.4203697879162409,-2.1202372307400115,-1.4181164732635316,,0.020613160785192708,0.34731421322193334,0.20991519496540065,,0.020382423839858443,0.35406835403953213,0.19995077086516533,,0.002060253596239514,0.3516715114708077,0.19803277471843872,-0.07129579251527252,-0.048817196767564575,-0.37883320047734487,-0.27051026935615596,,-0.03129275540161458,-0.4193992585198572,-0.2916879295368846,-3.8284875508643297,-0.0658968061830657,-0.3846236040969231,-0.27437617303448497,-5.46853410146773,0.0727511266732952,-4.603597169451329,-2.727765927957427,-0.2754418427239402,-0.06781733886302543,-0.43787962424963006,-0.2942988375362841,-3.9845554792135234,-0.03129275540161458,-0.4193992585198572,-0.2916879295368846,-3.8284875508643297,1.7170333461049223,-2.3661950661795768,-1.316355139710446,-1.5885340845860236,2.085351025190662,0.5465072791888271,0.41117124469109373,,-0.6880954333699881,0.2160327680347396,-2.392906945297174,,-2.219647350320219,-1.0455847028326917,-0.6036023852339978,,1.8176864222381113,-2.3906829578995117,-1.3277462284262926,-1.8927363876517405,-0.03842650527079672,0.021869220290550568,0.010040844847695251,,-0.04206730769230771,0.05715437397315689,0.08845331624367776,0.23849984512091935,,,,,-0.8793107945973924,2.699328019246931,-25.193116313855757,,1.5034899542994595,0.16184655983571117,0.09849255950351203,-4.953767333263523,-0.6209982656815783,-3.533471793198982,-1.7018977705190708,2.541835563349159,-0.04884789318785443,0.028934001809250137,0.021165100087939415,0.35558170818617774,-0.6015340431840359,-3.196609662620515,-1.498001746001865,1.7029505070909081,-0.062496206526797105,0.040941560368915685,0.03985637742145132,,-0.9968664443285704,-1.6398076685001348,-1.0811081169216707,,-0.6555575911501168,0.1937742835140339,-2.251088305405019,,0.03475310463069525,0.030076240837820456,0.0718590248424116,0.614896653227445,0.03730782108492914,0.7570128895468574,0.2823389357415991,,-1.1722481016310788,15.415786793390419,8.207289961333917,-5.377675913928708,-0.6713230960919214,-0.2950754066177629,-0.09985377545309213,,0.16002031618401347,1.19195589590564,0.7511986328066607,0.35374496222340635,0.16002031618401347,1.19195589590564,0.7511986328066607,0.35374496222340635,-1.102165310094806,1.6432384329038048,1.5002669248975655,0.04102169930555375,0.28234349571250905,-2.861061047337129,-1.54952966528644,,-1.1036526471853347,1.5686878259694137,1.4290845783202397,,-0.9970512764558267,-1.633185912693038,-1.0662254231494341,-3.6322321009653087,-0.9970512764558267,-1.633185912693038,-1.0662254231494341,-3.6322321009653087,-0.6195787167942237,-3.976769528731033,-1.9553071087050284,1.2078995779559534,1.5034899542994595,0.16184655983571117,0.09849255950351203,-4.953767333263523,-0.6978557866821877,0.014016072331198393,-2.2610669383118944,,1.5081439280967914,-0.04202162861782525,-0.22957789999254352,16.405733108760312,,,,,,,,,-0.16630404653292274,0.06706433400589203,0.1985765995285173,,,,,,0.07076058873858249,-28.295628708659994,-15.09286059229552,-6.927961449431907,-0.027621552264535332,-0.36060135929697273,inf,,-7.00734112499498,30.35930729678682,16.269448616731854,7.91662442000253,0.0,0.0,0.0,0.009316733343099248,,,,,,,,
2017,54334000,41031000.0,13303000.0,0.2448,0.0,635000.0,2860000.0,3495000.0,44526000.0,0.0,7906000.0,2944000.0,11441000.0,0.2078,9808000,0.1805,-9217000,591000,0.0109,196000,245000,0.0045,0.33,0.33,734183,734183,2049000.0,0.0,2049000.0,1436000.0,68000.0,16837000.0,20390000.0,0.0,0.0,0.0,0.0,389000.0,0.0,40047000.0,40436000.0,0.0,60826000.0,15085000.0,0.0,0.0,0.0,592000.0,15677000.0,125824000.0,0.0,0.0,867000.0,126691000.0,0.0,0.0,142368000.0,0.0,2092000.0,-77120000.0,,,-75028000.0,67340000.0,-6514000.0,60826000.0,245000,2944000.0,0.0,0.0,1489000.0,1782000,0.0,-2096000,4713000.0,291000,4969000,-329000.0,0.0,-90000.0,0.0,0.0,-419000.0,-1666000.0,0.0,0.0,0.0,-4213000.0,-5879000.0,0.0,-1329000,2049000,3378000,4640000,61.0,61.5,61.5,450.0,0.0,0.5,62.0,0.3316412859560068,0.0,-7906000.0,-644043.9932318106,60826000.0,9724000.0,8497000.0,14045000.0,-75028000.0,-75028000.0,-75028000.0,0.08539772518128612,0.047733593926182066,0.0,0.05263739095225826,-0.1455074170869069,0.05418338425295395,0.1563845842382302,0.17896712923767807,0.2584937608127508,0.35634176182707994,0.06432436411823168,74.00607205560466,13.359067153557083,6.319950203150985,-0.4481171588010074,-102.19250513836468,0.0,125824000.0,-1.6770272431625526,0.016284651576805698,2438000.0,0.019376271617497456,123775000.0,123386000.0,4713000.0,1.3006314983734133,0.01703131976781272,0.10049043648847475,0.03368625258935324,-0.20894865916724423,0.257735179035281,1.0747533518846446,0.895898449958538,0.13070102698220323,0.07748331305691646,2.0828428632492684,2.0685890901916943,2.034902837602341,-1.6770272431625526,-1.8975315882070694,-1.6497174388228395,-1.2334856804655903,-0.8107106680172735,-1.8975315882070694,10.818547329778866,0.016284651576805698,0.09865278714317824,0.036876907426246185,12.443667511581156,0.0628337995930824,52552000,inf,57.326530612244895,-0.0032654475662419365,6555262.267343486,51663000.0,0.12688504862945407,45149000.0,0.18819907417661522,0.31108108706726617,0.8932693256173347,603.3970588235294,30.490460157126822,26.517325524646168,0.21870581659158914,0.21870581659158914,-0.012466252312715302,0.21537575583069393,-0.014264856214574202,0.13969355209943116,0.13969355209943116,0.1077707274412831,-0.0032654475662419365,-0.18719677986884897,-0.0031768672199170124,0.0,-0.0,0.005408871206392003,inf,-1.2678788675895176,0.0011179429849077697,0.029296682339788906,1.0,0.0,0.0,-0.07226035583785817,0.024460488501688544,0.05289153172041543,1.6733302483124248,-0.13154552766371752,-0.054166563991632034,0.05083233590167067,inf,0.17517667844522977,1.2617219219287323,0.5887744131344688,0.6615740706243463,0.26642524573202264,1.129218314702631,0.48888374415410246,0.10865841210270193,,,,,-0.1081460674157303,-0.004247539980475261,0.016053533657202922,inf,0.0017513134851139256,0.06538384899028722,0.05837829938411683,-inf,-0.020185029436501245,0.05053804984863012,0.04930927243480705,-6.107953232889008,-0.12372817979650874,-0.047448635235892524,0.05024077424906544,1.9911221003620412,,,,,-0.0006320313487548912,0.14441358144393904,0.2699277611610244,,0.031173380035026232,0.07519120450692467,0.06426271269409929,inf,2.986411149825784,-0.46292823600121275,-0.5660491192813754,-0.10815114288085961,2.7576853526220617,-0.39158072721548437,-0.5406025771728877,-0.16066865357732427,3.1612218922358934,-2.090453461130755,-1.5258723989502827,2.766297376424425,3.490049751243781,-1.720646022078654,-1.3153488113411338,1.5176653289686435,-0.10104359699600118,-0.022134812144788962,0.3705987733059239,0.376453699056294,-1.0748480243161094,-0.05143528475232836,-1.3994128045674687,-0.8838007088345134,-1.0808605341246291,-0.08980770931523241,-1.3376820053271135,-0.925761442064859,-1.0716112531969308,-0.10735020794785177,-26.003393175616168,-12.928417735791623,-1.051126878130217,-0.038953714508711844,-2.7978710632040618,-1.7465528686341187,-1.0550122249388754,-0.07546624954775989,-2.6239761476703367,-1.734615836010823,-1.0505359877488514,-0.03851926836962131,-2.819286934156101,-1.7572068392083513,-1.0505359877488514,-0.03851926836962131,-2.819286934156101,-1.7572068392083513,0.0,0.0,0.0,0.0,0.0,0.0,0.0,0.0,-0.39342806394316165,0.5870068662838387,0.39842795117725677,,,,,,-0.39342806394316165,0.5870068662838387,0.39842795117725677,0.46742212720445464,-0.5537600994406464,0.1505914232875123,0.23801460878009043,,-0.7258064516129032,-0.4550065660557559,-0.32831256559516986,,0.21549234767542602,-0.03696173193942446,0.996178223797964,,-0.014785465790490893,-0.11419922595368133,0.5178096338582469,,,,,,,,,,,,,,,,,,0.08356545961002793,-0.3000602365094032,-0.24562924176929934,,,,,,-0.06333762133083853,0.013960063739947662,0.0369930189189676,,-0.06211439439625177,-0.027179735528900073,-0.005975857135413954,,,,,,-0.04676383012067076,-0.06607864242339893,0.058214009088510286,0.3312748020100361,-0.12199522728595547,-0.00840577779782159,0.1581986121141967,,,,,,,,,,,,,,1.0343642611683848,,,,-0.10273580586080588,-0.15335062185276413,0.36219376186952623,,-0.01888557927732637,0.024448175796617067,0.3389296985803678,,,,,,,,,,28.896551724137932,inf,inf,,-0.012348470083804353,0.026517446699022267,0.33589042203135583,,,,,,,,,,-0.02318401064858966,-0.016451367061304123,0.3334825088810973,0.6833342379093823,,,,,0.0,0.0,inf,,-0.0031668066955341523,0.029639716426164215,-24.591010436251004,-10.921797979446023,,,,,,,,,-0.0032548191250514336,0.030528658230533967,-3.995163025894776,-0.6334536684594994,-0.044470301103953225,-0.059334372237927556,0.04259717980362534,0.33882709486960794,-0.02250900360144059,0.016811982328772457,-0.043018458649389316,,-0.04676383012067076,-0.06607864242339893,0.058214009088510286,0.3312748020100361,-1.051126878130217,-0.038953714508711844,-2.7978710632040618,-1.7465528686341187,0.031173380035026232,0.07519120450692467,0.06426271269409929,,,,,,,,,,-1.6311996608732513,3.744187056666297,2.13511353618285,,-0.5012594458438286,25.599843405584963,13.45957451833591,6.462762743180731,,,,,-1.819069949198906,-2.022233551532199,0.5082889532960511,-7.072697791736506,0.46184863523573205,-1.587076213812731,-1.030915416001706,,-0.9801676548763034,-2.137351111614365,-3.9814092776064145,-1.0800362741964293,-0.521152548906235,24.456320932208722,14.50760006525754,8.042440344287554,-0.922240605057906,-0.23842361407312432,-0.08437950714573197,-inf,,,,,-inf,-inf,,,,,,,,,,,-0.9009690380524699,-0.24444494629431093,-0.074124949857825,1.9982920500862442,-0.5218140068886338,-inf,-inf,-inf,,,,,,,,,,,,,10.670360110803324,2.896460692167915,-12.336023584699252,,0.528998699609883,-0.2362055559008159,-0.6335130040645999,,,,,,-1.577574967405476,39.19213537973574,22.728483665214494,9.37502329967015,-0.39342806394316165,0.5870068662838387,0.39842795117725677,0.9760727753390105,2.136490250696379,0.9127603327080064,0.6154742197035941,12.510736268273526,-0.24503742271396034,-0.5629619167381743,-0.8940499997859777,-1.3501011873419408,0.1348837209302325,0.17764097887216898,0.17014576532525388,0.0900678016162127,0.1441860465116278,0.2159191583610188,0.17684192781843358,0.09363229932209462,0.1441860465116278,0.2159191583610188,0.17865989684976236,0.09454011663065548,-0.71875,0.8222348484848486,0.43667424242424246,0.33399188311688316,,,,,0.0,0.0,0.0,0.1,0.1428571428571428,0.2132165932891076,0.1762163838716845,0.09402643781965057,-0.04324457657704439,-0.04076701448063417,-11.223842658713256,-5.611060665624257,,,,,-0.0006320313487548912,0.14441358144393904,0.29873231007734885,,-1.659071166395395,-0.713836987855502,0.8337279559400512,-0.44091033218871845,-0.04676383012067076,-0.06607864242339893,0.058214009088510286,0.3312748020100361,0.25422417128853336,-2.7805464110656044,-1.9399281689111922,2.067492266957768,565.4666666666667,187.49733510200258,112.06393227725721,53.15566757850233,1.5125223613595709,0.8965613660590885,0.43110103134564,,-0.0032548191250514336,0.030528658230533967,-3.995163025894776,-0.6334536684594994,-0.0032548191250514336,0.030528658230533967,-3.995163025894776,-0.6334536684594994,-0.0032548191250514336,0.030528658230533967,-3.995163025894776,-0.6334536684594994,-0.186234433295281,-0.5926021981674964,-0.8986196453588331,-0.6054342682211246,-0.24108948982530765,-0.3529701797552171,0.3644001026805377,inf,,,,,0.07977633573028275,0.04176930556356099,0.007659103950689805,-inf,0.0772073554685615,0.11062439549874063,0.2252357077598298,,0.1114900462901931,0.05234054241686444,0.014001846062671875,inf,609.587970699746,202.23795107218666,120.91093739894765,57.35256521256544,0.3519139547186707,-2.4924196960622704,-1.7784255570451102,1.3839085655381624,1.7082192478997427,0.860631539143537,0.3840020069422383,,-0.7645367163929275,0.003495846723713466,-1.40718803035588,-37.79026295845358,0.05613140144332962,0.0273872163710653,-0.0011205392701981952,-0.4440411682735288,-0.07226035583785817,0.02446048850168862,0.05289153172041543,1.6733302483124248,3.1612218922358926,-2.0904534611307555,-1.5258723989502831,2.7662973764244256,-0.24503742271396034,-0.5629619167381743,-0.8940499997859777,-1.350101187341941,-0.922240605057906,-0.2384236140731244,-0.08437950714573197,-inf,-0.0032548191250515446,0.03052865823053393,-3.995163025894777,-0.6334536684594998,,,,,-0.01888557927732637,0.024448175796617067,0.32985885968065765,,-0.015681801579972676,-0.0053989106369338,-0.2532532131564965,,-0.3817520941033087,0.5499867138019043,0.18499501481145716,,-0.3476050307733476,-0.2587466287513019,-0.20802482522189064,0.1394744194334093,-0.3350470083335352,-0.2803312794011878,-0.35139476688861243,-0.29205922947000107,-0.0087532434250569,0.021916094438696427,0.3328879561530312,0.2693386929589973,-0.009019428314419042,0.03679204763804245,0.39802195899314663,1.0584235436099791,0.46184863523573205,-1.587076213812731,-1.030915416001706,,0.09802056144087157,0.13405044205401614,0.12322121883657182,,-2.5260062511960193,-0.37105198441435805,-0.34271391812178814,,-0.38432502262715407,0.749650560400557,0.2662784203776802,,-0.36367087693113376,0.6596634219016662,0.33842632250414345,0.16303794215851777,-0.099805836681778,-0.18179069310339266,-0.3753476383172173,,-0.05871784717025652,-0.11131210896714676,0.17064135773164255,,565.8249177839616,187.71888724695202,112.31232852690027,,1.8002035273122678,2.1482573219397243,1.0809079233249737,,-0.3239762156799719,0.8580934545888921,0.34966367597189707,,0.5335639597276174,-1.7820603672120476,-1.2002413640323992,,0.03610370769000815,0.1060608791787158,0.21522220657043353,,0.02924590119872761,0.10391673333246383,0.2075639005094808,,0.03987530886540491,0.1015579020413641,0.20968473437117874,-0.07763355472421878,-0.015681801579972676,-0.0053989106369338,-0.2532532131564965,,-0.0199942692534959,-0.045542362002664115,-0.2722667906379215,-4.06283963888878,-0.005516379116253911,-0.007533017989786413,-0.25335285546047837,-5.568533289255853,0.0456434746922445,0.10745403887376244,-2.739381981624151,-0.2261929369153443,-0.043651087389684484,-0.09362707746281584,-0.28423381867337605,-4.069701933988776,-0.0199942692534959,-0.045542362002664115,-0.2722667906379215,-4.06283963888878,-0.7513435721204365,-0.14223356718356453,-1.5677364372026594,-1.764792883442577,-0.3817520941033087,0.5499867138019043,0.18499501481145716,,1.572155235734669,0.9750869083475547,0.3766329694332059,,-0.23050506511774027,-0.5934863362013538,-0.726190147506957,,-0.7549635618006688,-0.09315893609061154,-1.5776619957661235,-2.203379720738847,0.018604912478124902,0.1113692900233304,0.015116240597855324,,-0.04438746749586309,0.013284939563527129,0.04644766270933256,0.4258727805512871,,,,,-50.14288634953087,-13.662564312857254,-8.546052558120902,,-1.0512938302699768,-0.0985720023627787,0.07319328357847972,-5.040859431519569,3.2566907646920553,-2.0792737913038546,-1.5126074033541772,2.8487966398497453,-0.025263197615184363,0.023349468852839988,0.017920988854267073,0.3129181514621708,3.3670155413005114,-1.7053337589541293,-1.2926877134817365,2.054943669260587,-0.025659286115067514,0.024971613911559887,0.029892249757207966,,580.3845799463998,192.51572681005743,115.07050147655048,,1.578689698125757,0.7923977378740652,0.358503732331812,,-0.026747333476041968,0.10533314269528497,0.026646229867664073,0.3719910620498012,2.1673045461676184,1.2213193389023542,0.9157998449751228,,0.8601648420826784,-0.43300416333565156,9.192354184918305,-4.42703477634912,0.529479999014014,-0.015586383096126108,0.06768897595823457,,0.23282845907325989,1.539768666728637,0.733699650097274,0.37554931540509817,0.23282845907325989,1.539768666728637,0.733699650097274,0.37554931540509817,-1.6761529520408942,-0.789011140828349,0.7903586313173583,0.181277170030767,0.28725419498035554,-2.378375353800718,-1.7059248553195314,,-1.6764278214009127,-0.7972474290907255,0.7377527450336756,,593.2563706309802,196.70408395240895,117.65353643892426,55.73855071756977,593.2563706309802,196.70408395240895,117.65353643892426,55.73855071756977,3.46551536670174,-2.464154621658994,-1.7406479795268048,1.5697427226657559,-1.0512938302699768,-0.0985720023627787,0.07319328357847972,-5.040859431519569,1.5207268713896012,0.8681785780192056,0.2341141369069545,,-1.0512893014334057,-0.09695592188079945,-0.24162200336463974,16.296637039929262,,,,,,,,,-0.9184258871000062,-0.1565821999299728,-0.11097601788013715,-inf,,,,,0.04573580483276829,0.10651946697660734,-16.742426614033384,-6.866995915200794,-0.7123550731170775,-0.42665988427672835,-0.361367604618476,,-0.4767922473826113,30.52866681047629,16.45234501193331,8.013441649351895,0.0,0.0,0.0,0.009316733343099248,,,,,,,,
2018,57099000,-250000.0,57349000.0,1.0043783603916006,0.0,0.0,38000000.0,38000000.0,37750000.0,0.0,7998000.0,2274000.0,20718000.0,0.3486,19349000,0.3389,-8903000,10446000,0.1829,5986000,3645000,0.0638,4.96,4.96,734183,734183,7623000.0,0.0,7623000.0,1809000.0,59000.0,12891000.0,22382000.0,0.0,0.0,0.0,0.0,267000.0,0.0,37758000.0,38025000.0,0.0,60407000.0,12119000.0,0.0,0.0,0.0,490000.0,12609000.0,123013000.0,0.0,0.0,1867000.0,124880000.0,0.0,1355000.0,137489000.0,0.0,2092000.0,-73475000.0,,,-71383000.0,66106000.0,-5699000.0,60407000.0,3645000,2274000.0,0.0,0.0,5060000.0,-373000,0.0,-2966000,9773000.0,-700000,10279000,-210000.0,0.0,0.0,39000.0,0.0,-171000.0,-2585000.0,0.0,0.0,0.0,-1949000.0,-4534000.0,0.0,5574000,7623000,2049000,10069000,70.0,70.0,70.0,500.0,0.0,0.5,70.5,0.5730423128470228,0.0,-7998000.0,6654192.418150488,60407000.0,55075000.0,18444000.0,20697000.0,-71383000.0,-71383000.0,-71383000.0,0.17634284313210388,0.0,0.0,0.6655107795232841,-0.1400725056480849,0.03982556612199863,0.3230179162507224,0.9645527942696019,0.3624757000998266,1.9639257842782574,0.6655107795232841,77.77216307105994,26.354464758786296,13.714564352484325,-0.2860322290219196,-97.22780287748422,0.0,123013000.0,-1.723281453567376,0.061969060180631315,7890000.0,0.06413956248526578,115390000.0,115123000.0,9773000.0,1.7750812911412484,0.6341502101673407,0.3405861853274953,0.12619398414091082,-0.17663869548772115,0.20873408710910987,2.3060765191297823,1.6414465857720675,0.6045681655960029,0.16178588574171868,2.067310079957621,2.0364030658698495,1.9102090817289388,-1.723281453567376,-1.9260748357452055,-1.6164913214630934,-1.1817007962653334,-0.8462378997800597,-1.9260748357452055,5.569553045660778,0.061969060180631315,0.1505356792179738,0.08096134053775891,6.636210058885993,0.06501751847365726,57472000,-inf,5.678189300411523,-0.05106257792471597,8261204.288722957,53497000.0,0.15442369270656217,47798000.0,0.38587388593665006,0.433009749361898,0.9452381346532687,-4.237288135593221,-153.08042895442358,7.490358126721763,0.9493767278626649,0.9493767278626649,0.12438440320299247,1.1522448638018328,0.13921487129483426,0.3053288526164186,0.3053288526164186,0.13675905588297643,-0.05106257792471597,-0.2899429836235518,-0.04960871044572984,0.0,-0.0,0.00347641829589286,inf,-1.2163325442415613,0.0009767079974175178,-0.006174781068419223,1.0,0.0,0.0,0.05088894614790007,0.0031734983489335087,0.04374380637225535,0.059879526148343874,-1.0060929541078696,-0.3775821766985206,-0.18128420800521625,inf,3.3109824851537244,1.2139502810090779,1.274689927615475,0.6026398324297366,3.1028527793774536,1.1635025744951155,1.148718103710575,0.490429218687819,,,,,-1.0,-0.3324605456128358,-0.1997447856705282,inf,12.286713286713287,4.114639155087699,2.507029324734171,1.3012192720003444,9.872675250357654,3.306179744889637,2.0136195219262074,0.996452101334036,-0.15218074832682027,-0.0889845878383642,-0.009519285639085263,1.279249054769125,,,,,0.011636731596256,-0.0038279567073179845,0.27990057432736626,inf,-0.2275815217391305,-0.046985092213136403,0.010054776353670313,-0.04185571050210936,0.8108556944323049,1.054899130307683,-0.3972020801179062,0.12276811268272163,0.6775745909528392,0.9442718862958753,-0.3977860716807326,0.009990825837940998,0.9727773246329527,1.1664940791640661,-1.2925927795117513,1.8800752700221068,0.8775623268698061,1.240599033380006,-1.086875147873231,1.6423735514499551,-0.034067483996962133,-0.01617592766177763,0.41144114890865807,-0.26032843040090253,16.6751269035533,5.747911283593514,1.9567453700508537,0.8073890302054245,15.779816513761467,5.420564540740796,1.8550489741928566,0.7477766731674128,29.540816326530614,9.982042716752254,-8.095229910310044,-9.93472342708222,13.877551020408163,4.834008121872287,-0.24543778219935247,-0.3520603991572452,13.177777777777777,4.5731969832214325,-0.1738751375693269,-0.3222711385848097,14.03030303030303,4.885332183583633,-0.23197632809549518,-0.3477545178294247,14.03030303030303,4.885332183583633,-0.23197632809549518,-0.3477545178294247,0.0,0.0,0.0,0.0,0.0,0.0,0.0,0.0,2.720351390922401,1.4878045258918728,1.0130408650206517,inf,,,,,2.720351390922401,1.4878045258918728,1.0130408650206517,0.4521400866415976,0.25974930362117,-0.29472630195171207,0.2514513677371093,,-0.13235294117647056,-0.2964697975964579,-0.357208732661776,,-0.23436479182752268,0.07937161722455821,0.9672201590494807,,0.09769494850416871,0.035736799442874854,0.5484114254914477,,,,,,,,,,,,,,,,,,-0.31362467866323906,-0.3861007577402369,-0.2374510001189099,inf,,,,,-0.057157839538542254,-0.006575218588841876,-0.0013656092047491298,,-0.05962508655653376,-0.04612980721720894,-0.02611356199607582,,,,,,-0.0068885016275934685,-0.0191279499349174,0.05181124335325702,0.003491873372379539,-0.19661915810407693,-0.04786804229182173,0.10138248374059629,,,,,,,,,,,,,,-0.17229729729729726,,,,-0.19570070804363082,-0.03450824570990455,0.33835230434676045,,-0.02234072990844349,-0.008217153594997676,0.33136144204160684,,,,,,,,,,1.1534025374855825,inf,inf,,-0.014294622348864583,-0.0032794560285451433,0.32840322013454565,,,,,,inf,,,,-0.03427034164980891,-0.007383429948338256,0.3258222232356213,0.15287962458199078,,,,,0.0,0.0,0.0,,-0.04726400414937759,0.005444738474205753,-24.836965138221565,-10.867175431865725,,,,,,,,,-0.04858186277123211,0.005637151525904123,-4.023894990011235,-0.6112628227120158,-0.018324918324918338,-0.020325213970675438,0.03710507034805841,0.009900524562218915,-0.12511513662879947,-0.029780806258526377,-0.05051670956712406,,-0.0068885016275934685,-0.0191279499349174,0.05181124335325702,0.003491873372379539,13.877551020408163,4.834008121872287,-0.24543778219935247,-0.3520603991572452,-0.2275815217391305,-0.046985092213136403,0.010054776353670313,-0.04185571050210936,,,,,,,,,2.3982538616521154,-0.18915361013931978,2.7913058634730588,,-1.2093153759820425,-2.898499814980483,14.922473347901406,6.465913256864579,,,,,0.41507633587786263,-1.4886801166079546,0.48187025820747265,-6.932952388553771,1.0736261404625504,0.37098069572652165,-0.7855287774843163,-inf,-3.4054982817869415,-2.4199505521410374,-1.6760224474773167,-1.1904417945183625,1.0686254779633728,25.097332825500796,14.723962271494205,8.159004384621204,-0.36170212765957444,-0.4844525769181289,-0.1950313906414638,-0.010142994759312296,,,,,-1.0,-inf,-inf,,inf,,,,,,,,-0.5918854415274464,-0.555441953569681,-0.23777403524254023,-0.1025631607331671,0.5516206482593038,-inf,-inf,-inf,,,,,,,,,,,,,-0.5373842867315453,3.0202634203947856,-12.557100442045561,-inf,-0.22878040483075357,-0.4895426453249066,-0.688632019393685,-1.821239414638584,,,,,-5.194130925507901,37.777852421660455,22.06216932845415,10.846519298028452,2.720351390922401,1.4878045258918728,1.0130408650206517,0.6110708773942137,-0.39342806394316165,0.5870068662838387,0.39842795117725677,0.2713934618792092,1.170043103448276,-0.43828571317329007,-0.6095857038684849,-0.34466404117621796,0.14754098360655732,0.18237686229657699,0.18015396204656536,0.1038410835914653,0.1382113821138211,0.11913247620848295,0.18498420424119782,0.10745343753347672,0.1382113821138211,0.11913247620848295,0.18498420424119782,0.10836125484203758,0.11111111111111116,-0.3225462962962963,0.49889646464646475,0.3451029942279943,,,,,0.0,0.0,0.0,0.1,0.1370967741935485,0.1180704475977552,0.18269481193289155,0.10773611523900542,0.7278979943499513,0.20721853332928505,2.3158827624026093,-5.517391658693894,,,,,0.011636731596256,-0.0038279567073179845,0.27990057432736626,-inf,-11.331891125573227,-4.6960456806361375,-1.5818289866877675,-0.6856666089251455,-0.0068885016275934685,-0.0191279499349174,0.05181124335325702,0.003491873372379539,4.663821472645002,1.706749178566567,-0.9684397198702509,2.1663752198941983,1.1706484641638224,188.5467509503865,112.31131093192505,53.29640947360333,0.47362050551797785,0.43635297726912076,0.5927084204091899,,-0.04858186277123211,0.005637151525904123,-4.023894990011235,-0.6112628227120158,-0.04858186277123211,0.005637151525904123,-4.023894990011235,-0.6112628227120158,-0.04858186277123211,0.005637151525904123,-4.023894990011235,-0.6112628227120158,1.0649594911077012,-0.4413279317101981,-0.6219952145157006,-0.35306024751264004,-1.0,-0.42665475345461074,0.11956561604855827,inf,,,,,11.643308634481858,3.9156366440291563,2.346017725989982,1.244536723412803,-0.03735143917492467,-0.003974983082368507,0.21609341428060985,-inf,-0.2649856285079233,-0.043223540114134464,-0.02929838449599218,-0.08452100496432344,1.0655355374328295,203.2187853084055,121.15374873530659,57.55467761461398,4.389552809938765,1.6358810812419893,-0.8475802790928764,1.8956605635955461,0.40226092482904785,0.47457322428691256,0.5430668446162102,,4.511354532818641,1.8878800287052329,-0.5656192766085768,-36.68378475445318,9.346169583581721,3.145468189785888,1.8764121966830511,0.9407066657676518,0.05088894614790007,0.0031734983489335087,0.04374380637225535,0.05987952614834389,0.9727773246329525,1.166494079164066,-1.2925927795117516,1.8800752700221064,1.170043103448276,-0.43828571317329007,-0.6095857038684849,-0.34466404117621796,-0.36170212765957444,-0.48445257691812876,-0.19503139064146374,-0.010142994759312273,-0.048581862771232,0.005637151525904123,-4.023894990011236,-0.6112628227120162,,,,,-0.02234072990844349,-0.008217153594997676,0.33136144204160684,inf,0.02758107275442745,-0.012305975197703267,-0.22492006605151596,inf,2.8053660459579084,1.5029883256817538,0.8126271578842161,,2.236259228876128,0.5010974519991723,0.31008897490742315,0.07578316266592494,2.310211776105858,0.5265938316905007,0.17753566708187524,-0.06103805185941523,-0.06774389012320747,-0.026058695294002693,0.3238408425537771,-0.024752875708420597,-0.06696869985249543,-0.013020402497445368,0.3749244697251391,0.7644094939696323,1.0736261404625504,0.37098069572652165,-0.7855287774843163,,0.3647841785787813,0.10667453460289085,0.19159131716756073,,36.23435522394532,10.870287577876667,6.888903783393431,,2.3892397846889355,1.3556645636991203,0.8070889218380721,,2.746156798123495,1.5102412928910667,0.9613732553126676,0.44696700298561653,-0.15463111277331487,-0.04546296434893741,-0.37493885371242286,,-0.1901218611661213,-0.016484132049835603,0.15244260970205287,,1.1456797646510601,188.65786761798753,112.54729069551267,53.36080456318139,0.8321792897934284,0.6342084722579834,1.3032011027312245,,3.6255808355532144,1.6421588134178065,1.134599613504387,,1.0880093965893867,0.40040118946692105,-0.9478276671806061,,-0.0074574916647413,0.016419792270153184,0.21411777113821334,,-0.015559409297117632,0.01135630524715614,0.21517831080404126,inf,-0.06127749864476317,-0.006447312061039582,0.206722468926613,-0.07444792357394567,0.02758107275442745,-0.012305975197703267,-0.22492006605151596,inf,0.015042304283907182,-0.012081573457067766,-0.2526299481058321,-4.820854612337038,-0.020140489866831146,-0.030517891722050255,-0.23590553625477084,-6.001475426524709,-0.0419825580631874,0.0254706811007841,-2.7614261183449864,-0.14747196523808215,0.04382233164597893,-0.022548698202243662,-0.2626935256985191,-4.550773314844703,0.015042304283907182,-0.012081573457067766,-0.2526299481058321,-4.820854612337038,-0.485184759479661,0.16016833816827494,-1.6670227060277654,-0.936091751915175,2.8053660459579084,1.5029883256817538,0.8126271578842161,0.3587567278789042,0.5259141031615875,0.46999130184208954,0.5492335286000951,,1.1954482137549522,-0.41823473389433574,-0.4343621919721727,,-0.46669982521553544,0.19867434507396897,-1.678742452142948,-0.8918092880358301,0.034753888746452244,0.004977431984593476,0.02379329241924577,,0.09362155579235809,0.002388926868062432,0.04413944204319313,0.06489993759981472,,,,,-0.9009500620433732,-17.307715735390545,-8.589170470766689,,14.637237128716691,5.029811084248725,2.8142965955907697,-3.6049786179983236,0.2602400867892052,0.9653108619332275,-1.4166969056231369,1.6508408283872424,0.03549929349824832,-0.012870599101596825,0.01940762026216287,-0.010625997662901598,0.21703616284634109,0.9941725536542722,-1.2011554567429386,1.866650053818385,0.05867239584486916,-0.009827698932331819,0.03116755816730974,,1.050349544092481,193.47935434872122,115.30310129699835,,0.39195138297901977,0.43836116331822,0.5103927863293757,,0.05817820845915489,0.02206132653793606,0.024331919499314857,0.07542924257956565,-1.0070223877853413,0.3991966598224021,0.6862641654045698,,-6.020600809746804,-2.110894689765068,8.217384882501426,2.207089667205156,-0.717529653593461,-0.2864575835571228,-0.21465517488654715,-0.132251556340869,3.340884676311693,1.2445778171896553,1.4299161646203746,0.6949013557695091,3.340884676311693,1.2445778171896553,1.4299161646203746,0.6949013557695091,-10.97769017366375,-4.585336145266484,-1.544825565398646,-0.6318878278567389,4.349928358267066,1.639842016319977,-0.7892001177527934,,-10.759290188470347,-4.513123552352198,-1.5459309063926037,,1.1857046945093894,197.81500801634456,117.90850351748209,55.93925089680552,1.1857046945093894,197.81500801634456,117.90850351748209,55.93925089680552,0.2689814676948068,1.0383060392007744,-1.6391623503593102,1.3866436377084004,14.637237128716691,5.029811084248725,2.8142965955907697,-3.6049786179983236,0.5488673674124489,0.4572461507066208,0.42232849115912907,,14.615607141121165,5.02415392259485,2.687650590766857,17.628775321005666,,,,,,,,,-0.35727471347726714,-0.4806682157033986,-0.21490151971191943,0.005063961927921734,,,,,-0.040655558402007075,0.025280278389781235,-16.976361175909844,-6.780579526676402,-0.12633469631003036,-0.28877044056388107,-0.3840987694636052,,-1.2107672465026194,-2.898300206293404,17.878072479295046,7.99800350704116,0.0,0.0,0.0,0.009316733343099248,,,,,,,,
2019,59881000,44466000.0,15415000.0,0.2574,0.0,766000.0,2309000.0,3075000.0,47541000.0,0.0,7813000.0,2071000.0,13754000.0,0.2244,12340000,0.2061,-8470000,3870000,0.0646,956000,2599000,0.0434,3.54,3.54,734183,734183,9789000.0,0.0,9789000.0,848000.0,61000.0,15906000.0,26604000.0,0.0,0.0,0.0,0.0,196000.0,0.0,35754000.0,35950000.0,0.0,62554000.0,13602000.0,0.0,0.0,0.0,151000.0,13753000.0,121308000.0,0.0,0.0,1811000.0,123119000.0,0.0,1486000.0,136872000.0,0.0,2092000.0,-70876000.0,,,-68784000.0,68088000.0,-5534000.0,62554000.0,2599000,2071000.0,1105000.0,0.0,3078000.0,961000,0.0,1483000,12851000.0,516000,9369000,-4000.0,-1395000.0,0.0,35000.0,-154000.0,-1518000.0,-1718000.0,0.0,0.0,0.0,0.0,-1718000.0,0.0,6133000,20816000,14683000,7970000,73.5,80.0,80.0,700.0,0.0,0.5,80.5,0.2470284237726098,0.0,-7813000.0,2087033.0749354009,62554000.0,12578000.0,11683000.0,16533000.0,-68784000.0,-68784000.0,-68784000.0,0.13309730966416727,0.04969185857930587,0.0,0.038559810290409315,-0.13047544296187438,0.03458526076718826,0.19510362218399827,0.21004993236585895,0.2760975935605618,0.2491896272285251,0.051351847831532536,81.56140907648366,16.80779860062137,10.855604120498567,-0.00544823293375085,-93.68781352877961,0.0,121308000.0,-1.7636078157711095,0.08069541992284103,9985000.0,0.08231114188676757,111519000.0,111323000.0,12851000.0,1.9344143096051771,0.6418963135315932,0.3679521876409563,0.15648879368225854,-0.19994475459409164,0.21985804265114942,1.4953282989888648,1.2021377154075474,0.711771977023195,0.20543850113501935,1.9682034722000192,1.9392524858522238,1.7827636921699652,-1.7636078157711095,-1.989881367759944,-1.6212927424982555,-1.0995939508264858,-0.9094266108397302,-1.989881367759944,8.10811400319907,0.08069541992284103,0.12079168858495529,0.06490545140642051,9.951432310600552,0.06440630461305108,58920000,inf,6.361292804924971,-0.03778494998836939,9291669.250645995,54335000.0,0.17100707188085018,48801000.0,0.23940083195016496,0.3387840413106289,0.9572689196534194,728.9508196721312,62.31113423517169,6.117172336295842,0.24642708699683474,0.24642708699683474,0.038410473450545705,0.25774062006926085,0.04276619485124077,0.18676663362854493,0.18676663362854493,0.1485383708579147,-0.03778494998836939,-0.24036113049546406,-0.03666967661831932,0.0,-0.0,6.394475173450139e-05,inf,-1.1330370559836302,0.0009751574639511462,0.015362726604213959,1.0,0.0,0.0,0.048722394437730854,0.009116994915924251,0.03459856121813931,0.05091117496382104,-178.864,-60.000546160590524,-36.00651852921655,-17.083845352689803,-0.7312071701337426,0.9183173311550705,1.2729882161612358,0.5242908496336292,-0.7437220771068371,0.8751853160008797,1.1493571292757019,0.42362226059331387,,,,,inf,inf,inf,inf,-0.9392368421052631,3.783075919364379,2.308725598315777,1.3120082753430378,-0.9190789473684211,2.9778037578509107,1.8210420905070248,1.011162522949192,0.2593642384105961,-0.0055148965709109765,-0.0070324831247803535,1.411803794962183,,,,,-0.023130782695673924,-0.004042027482724271,0.08434933864647984,0.12816765043141493,-0.08927000879507474,-0.095226050166393,-0.018255583402686248,-0.057757783289574635,-0.3361328313543779,1.1537113376345705,-0.1828123689851422,-0.07656118987019185,-0.35628227194492257,1.0263258905433261,-0.1706899725277073,-0.15883659652757745,-0.36224094268437645,1.25725275806149,-1.132164800288738,1.8952714190539872,-0.39185600472115667,1.3252520244641435,-0.9352463488174625,1.660514111960912,-0.04863529147478374,-0.061248790822582354,-0.02982144238122255,-0.21662818923046095,-0.6295232624928202,4.990251872248122,3.178259557360698,0.71690104626993,-0.6468015308911974,4.684051482915214,2.9727183709849148,0.6711385700125903,-0.84029401937855,9.209637017985044,5.675694336661701,-10.044894714345634,-0.2869684499314129,4.179818564115511,2.6947442853901227,-0.40925222742797845,-0.31974921630094033,3.934338778845987,2.5263259625667116,-0.3668846411461675,-0.28629032258064513,4.231158906657844,2.725690980522704,-0.404814922636509,-0.28629032258064513,4.231158906657844,2.725690980522704,-0.404814922636509,0.0,0.0,0.0,0.0,0.0,0.0,0.0,0.0,0.28414010232192055,0.87035447643372,0.9531024184191675,0.6785552393851997,,,,,0.28414010232192055,0.87035447643372,0.9531024184191675,0.5740858183038372,-0.531232725262576,-0.27508117369401747,0.03605816964422619,0.13160847187041663,0.03389830508474567,-0.2747536959015427,-0.2926948668517985,,0.23388410518966718,0.07167055367919017,-0.022273176491225778,,0.1886337235278348,0.09051440208050421,-0.011253801165808097,,,,,,,,,,,,,,,,,,-0.26591760299625467,-0.16532560734982193,-0.2959445982375407,-0.07701525673388072,,,,,-0.053074845065946286,-0.057856768645109025,-0.01367049867692911,,-0.054569362261669974,-0.0587696144048185,-0.03914673108098079,,,,,,0.03554223848229521,-0.006036697755323006,-0.03391643808309901,0.015933559386985284,0.12236983249443023,-0.06541485096520072,-0.019893331800622294,0.08547884830821942,,,,,,,,,,,,,-0.6918367346938776,0.056743409725736625,,,0.0907288444761678,-0.06923588980942297,-0.11300474582515108,0.2010759718640464,-0.013860323705624622,-0.01836221096379816,0.007428694755156617,inf,,,,,,,,,-0.029994643813604727,10.006653205936637,inf,,-0.014101537475976977,-0.013581543302881971,0.010231236054445047,0.15929072894434024,,,,,0.09667896678966792,,,,-0.004487631737811748,-0.020647328012070105,-0.017622414914306606,0.15877269830913163,,,,,0.0,0.0,0.0,,-0.03537257570602248,-0.028601128850311408,0.0012565138846185153,-10.683115033186327,,,,,,,,,-0.036409229088158246,-0.029415303661480596,0.0013189765664423092,-0.5672598964144827,0.029982149880494857,-0.010937689849458901,-0.03326917703164123,0.021786201716644627,-0.028952447797859326,-0.05885886267603313,-0.020726327488068286,,0.03554223848229521,-0.006036697755323006,-0.03391643808309901,0.015933559386985284,-0.2869684499314129,4.179818564115511,2.6947442853901227,-0.40925222742797845,-0.08927000879507474,-0.095226050166393,-0.018255583402686248,-0.057757783289574635,inf,,,,,,,,-0.39169960474308296,0.12511819867859364,2.6478230853815847,-2.587378524677353,-3.576407506702413,-1.7623274428427613,14.402761466814088,6.216449678255665,,,,,-1.5,-0.9679978711070145,-1.430324863743747,0.06182373084921413,0.3149493502506906,0.616808041982991,-0.6745306301449905,-1.6788350372254253,-1.737142857142857,-2.040936264602034,-2.310938894754579,-0.8271950946063648,-0.08853001264714466,0.1529809721366644,14.869811652388478,7.47618444120773,-0.9809523809523809,-0.7549650378899537,-0.41158507016626567,-0.04955458104987949,-inf,,,,,,,,-0.10256410256410253,,,,-inf,,,,7.87719298245614,2.1281128342920748,1.3103945404091524,0.7258565266175052,-0.33539651837524176,-0.10186329233485725,-inf,-inf,,,,,,,,,,,,,-1.0,3.044325274690593,1.43039955795444,-inf,-0.6210851345390384,-0.10695561325330298,-0.3116964414144479,-1.7885813811453357,,,,,0.10028704700394697,-2.22380628196981,22.496512452140653,10.937858098882694,1.7306834579561854,1.352535594978475,1.2424110895460205,0.8232095749486262,6.165934602244998,2.636332262999405,1.7021575072851711,0.9556291985264733,-0.20846161485748338,0.23884802195894406,-0.1454608523247461,-0.22291673366054643,0.050000000000000044,0.11080823484559661,0.14609278404461284,0.11171210201740445,0.1428571428571428,0.14175152382753056,0.18576520001080404,0.12389742520048597,0.1428571428571428,0.14175152382753056,0.18576520001080404,0.12479438642316684,0.3999999999999999,-0.06921296296296298,0.5955631313131314,0.32510299422799427,,,,,0.0,0.0,0.0,0.1,0.14184397163120566,0.14059929622729897,0.1837181051384154,0.12405246284868318,-0.5689176554078379,0.038578587455022996,0.007335859100042174,-5.573190575077085,,,,,-0.023130782695673924,-0.004042027482724271,0.08434933864647984,0.13255062189858016,-0.6863581718432655,-4.559106821270629,-2.8319520521965993,-0.7002499598827806,0.03554223848229521,-0.006036697755323006,-0.03391643808309901,0.015933559386985284,-0.7716205174761689,1.3821417088191221,-0.889887655605596,2.0864730171797734,-0.3665690739535893,188.75691535229228,112.65921693924358,53.356424515494815,-0.2011885780547905,0.5949847629409194,0.5924232051280905,-1.1525734535607755,-0.036409229088158246,-0.029415303661480596,0.0013189765664423092,-0.5672598964144827,-0.036409229088158246,-0.029415303661480596,0.0013189765664423092,-0.5672598964144827,-0.036409229088158246,-0.029415303661480596,0.0013189765664423092,-0.5672598964144827,-0.2452355462792445,0.21116317051105857,-0.1916165299348064,-0.24016879158383525,inf,inf,inf,inf,,,,,-0.942059826111261,3.5936750480336266,2.165311345012256,1.2544704659447123,-0.06851496403099955,-0.00955301591245424,0.045201356658059536,0.07863512813056725,-0.13158144039327957,-0.09502567420366992,-0.047909088330121904,-0.09164833110078678,-0.39599752097787255,203.41916957206698,121.47667824660297,57.61215443187094,-0.7822307564565015,1.319745336066978,-0.7739874069409097,1.8271883506256992,-0.23830040611129544,0.6240599222058317,0.5491710272296727,-1.021206926474473,-0.8731165763882965,0.9579004133458054,0.729745099320297,-36.657472802585445,-0.9228384431754559,2.8264875139498646,1.701098557903892,0.954236491526369,0.048722394437731076,0.009116994915924326,0.0345985612181394,0.05091117496382107,-0.36224094268437645,1.2572527580614896,-1.1321648002887381,1.8952714190539872,-0.20846161485748338,0.23884802195894406,-0.1454608523247461,-0.2229167336605465,-0.9809523809523809,-0.7549650378899537,-0.41158507016626567,-0.04955458104987946,-0.036409229088158135,-0.029415303661480558,0.0013189765664423313,-0.567259896414483,,,,,-0.013860323705624622,-0.01836221096379816,0.007428694755156617,0.1559976662081457,0.023400914644705173,0.011766728606386648,0.006957051097666245,-5.10796432743529,0.30218886146772195,0.9086009377741071,0.9515030097662687,0.5868493465199653,0.2655259822560203,0.7180600601196002,0.34510906497564847,0.11984125601636494,0.283313117479967,0.7528259617507634,0.3505062110764524,0.06638797270714368,-0.033547101135280366,-0.03668141156118158,-0.007108541588479711,0.15746982498794826,-0.03300817386621269,-0.036332100677709055,0.002079853839083845,0.8706598610876984,0.3149493502506906,0.616808041982991,-0.6745306301449905,,0.08976096996745953,0.18418856999570413,0.17133929494165784,,0.012214934632298391,11.2401879691272,7.0266828410669095,3.6982245746371007,0.08034971320738338,0.6950881584230549,0.943708235819598,,0.24006540206797733,0.8741837744201127,0.9930424931792942,0.563874324222393,0.13194197931557183,-0.04083165671317368,-0.1136122425535842,-3.4658749257292505,0.05329247223633771,-0.0651824120333467,-0.09415314316624476,0.11697284409585398,-0.3515703895406126,188.87300905302402,112.7901542231933,53.42564752422733,-0.2676351909178255,0.7882492087292903,1.4018632129389552,-1.0003857787209296,0.1773229513689445,1.1596425237473957,1.275436830137767,0.5897134800659986,0.2698172043449416,0.6304635202206486,-0.7976709001403629,,-0.047939885128230664,-0.006431223034321272,0.05255705214863508,0.11608309094072455,-0.047706950380242086,-0.011340152826210703,0.04969676806400636,0.1112854991061302,-0.06671803143330368,-0.029373407070887314,0.03533563520920509,0.1128052289964652,0.023400914644705173,0.011766728606386648,0.006957051097666245,-5.10796432743529,0.03312775330977802,0.009391929446729766,-0.017691405682861427,-4.896428484858017,0.002970273314437888,-0.007562198556215723,-0.0079538541043505,-5.737725949934381,-0.0694819244417364,-0.021940335937559768,0.04217952682327271,-0.11188332580216453,0.07467015017419265,0.024947131476829032,-0.03247775011365519,-4.6173308154810835,0.03312775330977802,0.009391929446729766,-0.017691405682861427,-4.896428484858017,0.45579258097130015,-0.2602452502095991,-0.0912185760118109,-0.7583061514990885,0.30218886146772195,0.9086009377741071,0.9515030097662687,0.48897561402567646,-0.19758764691226183,0.6334938973279982,0.650717436258398,-1.2299479263764765,-0.19831550496437522,0.2555425478909456,-0.15666525996269684,-0.31338032226827944,0.49956559878260975,-0.2406992627445315,-0.04932220694095211,-0.7771001939687772,-0.009400756518473163,0.014652681568701328,0.07189220045959406,0.009687966348118238,0.025194877505567925,0.02480965526735431,0.03173425039770148,0.04910384633065954,,,,,0.12030305232408156,-16.97451111975005,-8.35366798965821,-17.8775868731584,-0.2600265884719417,4.441972236658258,2.8162989066312827,-3.7764060862132354,0.12473544121523372,1.2138887642321647,-1.170569169181425,1.7143691979748052,0.015664429781109268,0.008633508554724409,0.02424242596757551,0.015129506429887241,0.10738882669902194,1.2304801769486249,-0.9583152574634048,1.9128267832507462,0.020984141595882688,0.017999083775228113,0.030914275835086304,0.002403510826030775,-0.37958788952754363,193.68511386698822,115.64358841694744,54.45350910737252,-0.2176064353981041,0.5843448819022242,0.5103076322406223,-1.161594760096765,0.012727782089075212,0.014719552357396045,0.077381083726817,0.05175698760744737,-173.03239344262295,-57.29070376141356,-34.07509156274024,,-1.4070483383197436,-2.1891614353279563,-1.7453323276147004,3.5585603895983846,-0.18332712097264048,-0.12379225851736249,-0.18952318477089594,-0.050584268438133,-0.7404327705065861,0.9444267882927889,1.4439515811982035,0.6053654491809866,-0.7404327705065861,0.9444267882927889,1.4439515811982035,0.6053654491809866,-0.6911954195104293,-4.448346181738358,-2.8071838031318452,-0.6616154224831517,-0.7763143684417516,1.28695606160189,-0.7123024143153678,2.2713518301357203,-0.6928044076507531,-4.376174139174004,-2.7687673766786554,-0.6690487804176096,-0.38830990904361784,198.01792180548202,118.18192932853853,55.99676722451144,-0.38830990904361784,198.01792180548202,118.18192932853853,55.99676722451144,0.08613188281306727,1.273542905736538,-1.4074701028938215,1.4415373536780733,-0.2600265884719417,4.441972236658258,2.8162989066312827,-3.7764060862132354,-0.17100552842645256,0.6328629034585326,0.5964795146087226,-3.172928083009472,-0.26082181357173884,4.434498675372007,2.8127835123814053,17.849380835162712,,,,,,,,,-0.9816061399141618,-0.7524355801638117,-0.3617254906362694,-0.03844315340974702,,,,,-0.06848085143513905,-0.021133535001459276,0.04208439821853518,-6.591285348271119,-0.0015875097475103184,-0.28009242639153936,-0.28158037177754514,,-3.487979158125342,-1.7251795506701908,17.37745080536018,7.758180395636183,0.0,0.0,0.0,0.009316733343099248,,,,,,,,
2020,42839000,37333000.0,5506000.0,0.1285,0.0,747000.0,2192000.0,2939000.0,40272000.0,0.0,7456000.0,1997000.0,4296000.0,0.1071,2567000,0.0599,-7724000,-5157000,-0.1204,-1934000,-2933000,-0.0685,-3.99,-3.99,734183,734183,4710000.0,0.0,4710000.0,251000.0,37000.0,18443000.0,23441000.0,0.0,0.0,0.0,0.0,87000.0,0.0,34026000.0,34113000.0,0.0,57554000.0,10228000.0,0.0,0.0,,,10228000.0,123769000.0,0.0,0.0,1098000.0,124867000.0,0.0,1098000.0,135095000.0,0.0,2092000.0,-73809000.0,,,-71717000.0,63378000.0,-5824000.0,57554000.0,-2933000,1997000.0,-1920000.0,0.0,362000.0,597000,0.0,-3374000,13213000.0,-2910000,-5404000,-3000.0,-1288000.0,0.0,29000.0,-3000.0,-1265000.0,-1872000.0,0.0,0.0,0.0,4110000.0,2238000.0,0.0,-4431000,16385000,20816000,-6695000,52.1,44.9,44.9,200.0,0.0,0.5,45.4,0.37502423889858444,,-7456000.0,-11354819.274772154,57554000.0,2762000.0,2299000.0,6860000.0,-71717000.0,-71717000.0,-71717000.0,-0.15628282639650787,0.13567017798764983,0.0,0.051168327925488456,-0.17404701323560307,0.0466164009430659,0.053666051961997245,0.06447396064333902,0.16013445692009617,1.1449162446435528,0.06860570975046103,58.34921266223816,3.4964034852346075,-9.118979872865484,-0.004086174700313137,-97.68273032745242,0.0,123769000.0,-1.725797230782102,0.0380547633090677,4797000.0,0.03875768568866194,119059000.0,118972000.0,13213000.0,2.291845913179507,0.4021314039890497,0.20092999445416151,0.08183618862285853,-0.14261611612309494,0.17771136671647497,0.3083422746781116,0.670707860774345,0.46050058662495114,0.2295757028182229,2.1695624978281267,2.1504847621364283,2.06864857351357,-1.725797230782102,-1.8837235244084387,-1.6601224256452445,-1.2460819404385446,-0.8025154426426091,-1.8837235244084387,27.713919925512105,0.0380547633090677,0.05077908138717199,-0.05361704853964618,31.44669459962756,0.060241255887984874,42242000,,-2.3389021479713605,0.04089685848543581,1604312.7787473337,53150000.0,0.030184624247362814,47326000.0,0.048577948696276886,0.1449520348222964,0.7443270667547,1009.0,71.7571189279732,9.095329087048832,0.09566667824999131,0.09566667824999131,-0.2136372394124582,0.05836115454507036,-0.23992771995884196,0.03994509504117872,0.03994509504117872,0.027874913624549705,0.04089685848543581,-0.09565375015686657,0.039737701364332266,0.0,-0.0,5.212496090627932e-05,inf,-1.2824304131771902,0.0006428745178441117,0.010372867220349585,1.0,-0.0,0.0,-0.28459778560812277,-0.061662148340830614,-0.045270979224718275,0.03557278980657698,-0.16041469887104753,-60.01016921765964,-36.03143224579332,-17.95618493314374,-0.6428154395069737,0.6456532918376694,0.4535656466773036,0.5442876561983957,-0.5007770007770008,0.6194512338312053,0.4492017291203017,0.4554453067928188,,,,,-0.024804177545691863,inf,inf,inf,-0.05067128627111306,3.765601719445637,2.270801867377344,1.086629620236176,-0.04422764227642273,2.9697895535709367,1.7910465290048134,0.8528799539300678,-0.15289960244841294,-0.01523870412154571,-0.03209782551058189,0.030098572960464875,,,,,-0.04569307564315883,-0.01906237558085892,-0.016061545692157342,0.1253846267586461,-0.03573153066151613,-0.11752768706524046,-0.05319136321920002,-0.06119649763737537,-0.6876545005089428,-0.07097721247700532,0.4281820118119456,-0.17604141498388587,-0.5227272727272727,-0.06714498457311868,0.3907612228430861,-0.26158387082360063,-0.7919773095623988,-0.06048030920460749,0.4690527970490847,1.9167839066736367,-0.7093643862202814,-0.07455268802387731,0.5241153418397161,1.6903987673599317,-0.08807556080283352,-0.05692611209152646,-0.03704772705259003,-0.1298386991911958,-2.332558139534884,4.571015167175198,2.856330489750568,0.527354458784289,-2.8637770897832815,4.089745964362329,2.550223000309582,0.41997212863989597,-3.0230125523012554,8.559169918283603,5.216564315715391,-10.26191091564664,-2.12851096575606,3.8206905349068965,2.4173089899858775,-0.6064864577880718,-2.578341013824885,3.4265625158839845,2.1643001439076945,-0.6219628370168448,-2.1271186440677967,3.872298021218196,2.4485175168204916,-0.6018779320814565,-2.1271186440677967,3.872298021218196,2.4485175168204916,-0.6018779320814565,0.0,0.0,0.0,0.0,0.0,0.0,0.0,0.0,-0.5188476861783635,0.8285479356886527,0.8457411987638352,0.6835776872622088,,,,,-0.5188476861783635,0.8285479356886527,0.8457411987638352,0.4422417118991871,-0.7040094339622642,-0.3251642852012235,-0.4238842130159953,0.049716300404014736,-0.39344262295081966,-0.1639657530141815,-0.24979074213108957,,0.1594995599144977,0.053006291092214074,0.1262997033555679,0.5046565087228247,-0.11889189595549543,0.05581225869216936,0.035390445180192784,0.2403591376510364,,,,,,,,,,,,,,,,,-0.5561224489795918,-0.3785549102130285,-0.3960684650393114,-0.038580353267700304,,,,,-0.04833025675448899,-0.052854313786325845,-0.02422615151739218,-0.006869823606031511,-0.051098748261474314,-0.05509773235989268,-0.04881150643495422,-0.013776767831421066,,,,,-0.0799309396681267,-0.01709240093780832,-0.020354510198116738,0.019718198458223757,-0.24805175709454497,-0.10743369423473055,-0.05385721029511599,0.04640900611068564,,,,,,,,,,,,,,,,,-0.25630771468043334,-0.12042652608263212,-0.05382072146679584,0.1500206249714277,0.020287202822567352,-0.005304616930500254,-0.00364491633361006,0.16316522200691935,,,,,,,,,-0.39370513528437323,0.2432342527958682,inf,,0.01419764617971242,-0.004732837881709713,-0.0019484518763799974,0.16223323998185651,,,,,-0.26110363391655456,inf,,,-0.012982932959261229,-0.017246968782293964,-0.007924170908417549,0.15431054158635357,,,,,0.0,0.0,0.0,,0.04138213217450204,-0.013751482560299344,0.004468754378219364,-11.66437258362551,,,,,,,,,0.042640730402419225,-0.01411678715232371,0.00462859117839467,-0.14428431224207555,-0.06917518505463516,-0.01917265116635288,-0.02003373541723332,0.026646416249232252,0.05240332490061439,-0.03388808650868147,-0.013178308334564815,-inf,-0.0799309396681267,-0.01709240093780832,-0.020354510198116738,0.019718198458223757,-2.12851096575606,3.8206905349068965,2.4173089899858775,-0.6064864577880718,-0.03573153066151613,-0.11752768706524046,-0.05319136321920002,-0.06119649763737537,-2.737556561085973,,,,,,,,-0.8823911630929175,0.3747210312720383,-0.368310319650792,-2.472570687939691,-0.3787721123829344,-1.72149833168913,-2.5301358128053595,6.1421141336840375,,,,,-3.275118004045853,-1.4533472227226634,-1.8482316707739432,-0.14628128989435427,0.028169014084507005,0.47224816826591604,0.29121209030295253,-1.5729711827700215,-6.6395348837209305,-3.927392007550243,-3.12730587945738,-1.2952745228280818,-1.5767958159888995,-0.19890011689089046,14.725334529573269,7.261003524851764,-0.25,-0.5308848362039852,-0.5368620223413535,-0.10857308053600487,-0.07670250896057351,,,,,,,,-0.17142857142857137,inf,,,-0.9805194805194806,,,,-0.16666666666666663,2.372880291420676,1.2088400910160861,0.7287436657251168,0.08963911525029111,0.10195441504478438,-inf,-inf,,,,,,,,,,,,,inf,inf,inf,,-2.30267753201397,-1.0508476904612538,-0.8784781205055456,-0.5590452127781053,,,,,-1.7224849176585684,-2.272109598720841,22.342271878865347,10.77686362640944,-0.2128651037663336,1.412723248370751,1.196246386373094,0.8588302810668381,0.4176939317578152,2.06340015668655,1.6689298265708659,1.0364689434610486,-1.8400250941028857,-0.2928145351706977,-0.6726687696960478,-0.4898081319597239,-0.291156462585034,-0.03120515965949222,0.06119482486093939,0.1320817498765481,-0.43875,-0.052560491676345356,0.012300914296518339,0.12950771931813304,-0.43875,-0.052560491676345356,0.012300914296518339,0.1304004065892404,-0.7142857142857143,-0.06772486772486774,-0.25638492063492063,0.2661744227994228,,,,,0.0,0.0,0.0,0.1,-0.43602484472049696,-0.05236136629858094,0.01200609394079486,0.12956684620118458,0.5181420549555669,0.22570746463256008,0.11417599990711683,-5.447517325101482,,,,,-0.04569307564315883,-0.01906237558085892,-0.016061545692157342,0.13028092011613024,-6.44065132993813,-6.152966875784874,-4.243029308737961,-1.358485474734077,-0.0799309396681267,-0.01709240093780832,-0.020354510198116738,0.019718198458223757,-0.780410240101765,1.0372635716890226,0.7136433556243533,2.1069156217256895,-0.803218351450826,0.00028701291980241334,112.89409308515101,54.88443601368307,-0.5850722796830581,-0.10421345073995691,0.10455961481390272,-1.162919369638312,0.042640730402419225,-0.01411678715232371,0.00462859117839467,-0.14428431224207555,0.042640730402419225,-0.01411678715232371,0.00462859117839467,-0.14428431224207555,0.042640730402419225,-0.01411678715232371,0.00462859117839467,-0.14428431224207555,-2.174199739955996,-0.45149193170917973,-0.7486838162731668,-0.5680996106007458,1.730229495665303,inf,inf,inf,,,,,0.32698598722658034,3.676078265199059,2.2263672186405574,1.0184804553211582,0.33394460508910107,0.07602606729439228,0.0507009383621992,0.09957337180352879,0.3478690028352145,-0.01623268868866279,0.017323388419906306,-0.07180982282537417,-0.7249356451650811,-0.018465876236708034,121.7070845518147,59.375799823104316,-0.6930541232879803,0.9714226433980944,0.6864716727962972,1.8561375472238701,-0.420007777485497,-0.08534908625591486,0.1530822978527891,-1.0228756594769917,3.5945581980167294,2.410932051482358,1.6770163415488262,-0.4541187788245303,0.3359930099406039,2.9197747167822894,1.7699118272245624,0.7956351982237108,-0.28459778560812277,-0.06166214834083054,-0.04527097922471823,0.035572789806577,-0.7919773095623988,-0.06048030920460756,0.46905279704908454,1.9167839066736367,-1.8400250941028857,-0.2928145351706977,-0.6726687696960478,-0.4898081319597239,-0.2500000000000001,-0.5308848362039852,-0.5368620223413535,-0.10857308053600483,0.042640730402419,-0.01411678715232371,0.004628591178394648,-0.1442843122420759,,,,,0.020287202822567352,-0.005304616930500254,-0.00364491633361006,0.15889790399218834,-0.021439338525768292,0.009847549624454777,-0.0069912698948345845,-4.97900537386906,-0.5284148301668827,0.8597133590862492,0.8565478016692202,0.5905362169904487,-0.5195793690535804,0.6607352806928559,0.2498477938399914,0.14828686264224053,-0.5291319643945716,0.6881309763970845,0.2667925296313795,0.09370603173039428,0.06761179709287202,-0.011226398055205275,-0.008822277984883286,0.17121203736319962,0.06870997008704394,-0.010422301210554727,-0.0006718822543009706,0.19147657013416827,0.028169014084507005,0.47224816826591604,0.29121209030295253,-1.5729711827700215,0.18477510314079693,0.21310675056234593,0.1189119353833858,0.1179934081228066,-0.3735259176414364,11.957681413645394,6.449910350124171,3.714214624646742,-0.4539236313761863,0.6718886221733774,0.7386839545857115,0.3337134121612729,-0.47704761026516573,0.8363915299754355,0.8587483340952025,0.41218553061095997,-0.286722392829858,-0.10313717542920035,-0.05823386131221968,-3.3551935266767314,-0.1916994958494601,-0.1095096282597479,-0.03757188395252584,0.05563405239911744,-0.7937962687614409,0.00010436878300223995,112.96564723913211,54.98203437997542,-0.4420706944154378,0.04082446815338836,0.23858390628813736,-0.9871158318426698,-0.3530223140409692,1.1499604909603967,0.950155415516279,0.510931123512877,0.11749113019151158,0.4917725770419466,0.31770238058744327,-1.566391960149548,0.10230600061030892,0.01563620793911232,0.020725098458507563,0.11468965664892124,0.10892458708973951,0.01521940913745993,0.019057310490193168,0.10981575503814625,0.1603605024037864,0.010788324108573185,0.014860106957472797,0.12340421608117154,-0.021439338525768292,0.009847549624454777,-0.0069912698948345845,-4.97900537386906,-0.05334883027273618,-0.00172625755968366,-0.011293159466832292,-4.769394325719107,0.023949828509783,0.0022598706524632473,-0.012926714668385974,-5.606145021773928,0.13322007592162022,0.007251864472232139,0.028030038956447224,0.3626983978542292,-0.11755887382534735,0.00031120266494140864,-0.02210696365157714,-4.501405786461022,-0.05334883027273618,-0.00172625755968366,-0.011293159466832292,-4.769394325719107,2.4180476390166112,0.7962184868360834,0.6708690468985472,-0.4876631727049997,-0.5284148301668827,0.8597133590862492,0.8565478016692202,0.35459262724385593,-0.5796144421686926,-0.08376266197312232,0.12655436328906278,-1.2381582526992265,-1.826079279595648,-0.2763155236016903,-0.6558197972486062,-0.39598825022784423,2.1600169320480265,0.7309609018717002,0.6511211132105086,-0.5400213795106874,-0.06466833876108169,-0.013105068844367537,-0.011827359865154884,0.0041439413022346435,-0.2830617786829599,-0.05474844846167796,-0.050140024114640934,0.03379339112170769,,,,,-1.367677171873076,-0.7161080605307891,-10.634104265144126,-17.97578711339187,-2.082358412490272,4.098284042584826,2.5494096503567922,-3.858165590449917,-0.8273385830392321,-0.1474543516782644,0.4386658887951368,1.732699998501183,-0.0218091469586823,0.009784858773558428,-0.008951302896472701,0.03223519898489613,-0.823489029340295,-0.166354679931644,0.4532834916643087,1.9317969412482903,-0.030224790475605,0.016477248988382282,-0.007744749135343554,0.018667639029347392,-0.7970852970703579,-0.0421078808351402,115.85227797191314,56.3425528156263,-0.5721403102060796,-0.13259845420838798,0.10506734887009524,-1.1830344249850484,-0.22244726484571897,-0.050513758099162955,-0.028707100628567118,0.031035301067084353,0.38418117213151626,-57.885078219425594,-34.29012445820484,,0.15159384929747732,-2.4253517662563566,-1.5176277116634942,3.610053009388763,0.48685186341445563,-0.1380016370505486,-0.11116960164591065,-0.1035073318539574,-0.6117850540869312,0.6628889505727252,0.47630312539508973,0.6263664433182334,-0.6117850540869312,0.6628889505727252,0.47630312539508973,0.6263664433182334,-6.561952775393947,-6.076946122856043,-4.201831326140765,-1.3592622955617808,-0.773566329865322,0.9333492199866642,0.6739290701305715,2.2921164860799843,-6.610219024475144,-6.0207712068654144,-4.168478817836498,-1.3715222784043584,-0.7861229585546612,0.003757275637036835,118.45411823628709,57.7278517946228,-0.7861229585546612,0.003757275637036835,118.45411823628709,57.7278517946228,-0.8123386336907275,-0.15240842772761778,0.4777422733449326,1.4615102818220327,-2.082358412490272,4.098284042584826,2.5494096503567922,-3.858165590449917,-0.6020415199425446,-0.07472656031884943,0.11973828075017301,-3.116867153166838,-2.0836665340124716,4.090372931178985,2.545594684040068,17.73323977019566,,,,,,,,,-0.18484379886715074,-0.5079082174195265,-0.5216909171783017,-0.10883759421558233,,,,,0.13185213705465815,0.007571909072504009,0.02784242415777256,-7.708396975752895,-0.3407479903406465,-0.15622339879939573,-0.24172936435596,,-0.324802980123051,-1.6745164615836707,-2.5015365514257204,7.6710244833685906,0.0,0.0,0.0,0.03553511705685619,,,,,,,,
2021,14668000,17911000.0,-3243000.0,-0.2211,0.0,796000.0,2079000.0,2875000.0,20786000.0,0.0,7423000.0,1847000.0,1838000.0,0.1293,-6118000,-0.4171,-1314000,-7432000,-0.5067,-2146000,-5228000,-0.3564,-7.12,-7.12,734187,734187,2310000.0,3536000.0,5846000.0,194000.0,37000.0,6603000.0,12680000.0,0.0,0.0,0.0,0.0,20000.0,8055000.0,31796000.0,39871000.0,0.0,52551000.0,10823000.0,0.0,0.0,0.0,1715000.0,12538000.0,123536000.0,0.0,0.0,0.0,123536000.0,0.0,664000.0,136074000.0,0.0,2092000.0,-84960000.0,,,-82868000.0,53206000.0,-655000.0,52551000.0,-5228000,1847000.0,-2081000.0,0.0,-13071000.0,57000,0.0,595000,142000.0,7846000,-10687000,-1068000.0,-696000.0,0.0,29000.0,980000.0,-755000.0,-2011000.0,0.0,0.0,0.0,5600000.0,3589000.0,0.0,-7853000,8532000,16385000,-11755000,40.5,44.0,44.0,600.0,0.0,0.5,44.5,0.288751345532831,0.0,-7423000.0,-17034598.762109794,52551000.0,-5886000.0,-9000.0,-15196000.0,-82868000.0,-82868000.0,-82868000.0,-0.8014044177802018,-0.24545174221399937,0.0,0.14173711480774476,-0.506067630215435,0.12592037087537497,-0.0006135805835833107,-0.40128170166348515,-1.0359967275702209,-0.4699248120300752,0.19600490864466866,19.978561320208613,-8.333026871900483,-16.010907302907842,-1.4546702679290153,-112.87042674414012,0.0,123536000.0,-1.490756383646281,0.018699002719854942,5866000.0,0.047484134179510425,117690000.0,117670000.0,142000.0,1.0113255702663901,0.17969373105758493,0.4610410094637224,0.11124431504633595,-0.15130086402471402,0.23858727712127267,-0.0012124477973865014,-1.2119955335779231,0.46626256181209125,0.0027021369717036784,2.350783048847786,2.350783048847786,2.23953873380145,-1.490756383646281,-1.642057247670995,-1.4202104551817347,-1.5769062434587353,-0.6341531109716658,-1.642057247670995,64.03155603917301,0.04732223805206579,-0.11167453003512795,-0.09464573268921095,74.03373231773666,0.060087747701074994,14611000,inf,2.906656465187452,0.06308828498334701,-4351419.26803014,40668000.0,-0.1069986049972986,40013000.0,-0.00022492689875790368,-0.37977657261390046,0.27911933169682784,484.0810810810811,257.3333333333333,6.34978354978355,-0.06171148027630302,-0.06171148027630302,-0.418869842679989,-0.147102191787669,-0.42572660790517564,-0.00017126220243192326,-0.00017126220243192326,-0.08280373861639435,0.06308828498334701,0.18337597142443404,0.06153483992467043,0.0,-0.0,0.020323114688588228,inf,-1.6167151909573556,0.0007040779433312402,0.0010846606154021807,1.0,-0.0,0.0,-0.6576017180606457,-0.29782570307701256,-0.18296970378419913,-0.02975777900140709,-0.5202367878284628,-59.84821716223317,-36.136457993694215,-18.007813456242566,-1.588993824918271,-0.9876721448529957,0.10462854580799341,0.38598936660274347,-2.7206225680933853,-1.3217072153257412,-0.11916872417354947,0.18356236857284064,,,,,0.06559571619812576,inf,inf,inf,-0.05155109489051091,-0.3471530744222957,2.2494010753863027,1.0891383893699607,-0.02177611432460025,-0.32836090132314805,1.7734815033903417,0.8571511366255351,-0.4838597536750099,-0.12579837257094226,-0.13066080916723116,-0.016844265626713605,,,,,-0.004425965665236009,-0.024416608001356255,-0.012449024751313532,0.12120705130287272,-0.07511266900350522,-0.06670473615336536,-0.07930447003284007,-0.07521438333961057,-0.5721601489757915,-0.5319824936130374,0.4402638726837953,-0.19974939354324003,0.20728291316526604,-0.22390887716897642,0.5527066624135943,-0.22927301069973466,-3.3833268406700427,-1.5125150309722726,-0.08070917520959435,1.7232788088135287,-7.963272120200334,-3.0214975037139244,-0.9393760866056375,1.0391419778751092,-0.8298808907301916,-0.3221972476692696,-0.2203405648001544,-0.3811179275047213,0.4411479542369594,-0.8403111492635814,2.615869086289289,0.4432683712057776,3.2084717607973428,-0.10070228662571205,2.8793698239519405,0.6116526380529634,0.10961737331954491,-1.2512297327867536,4.943103174994684,-10.769273785644527,0.7824752812819638,-0.544334711468503,2.2386840015744873,-0.5343462708073151,4.202919708029197,0.43494315930112387,2.6855190061484544,-0.20814859900744756,0.7844611528822054,-0.5429826045887455,2.270163845757588,-0.5293141697344124,0.7844611528822054,-0.5429826045887455,2.270163845757588,-0.5293141697344124,5.448232933691344e-06,1.8160776445637812e-06,1.0896465867382688e-06,5.448232933691344e-07,5.448232933691344e-06,1.8160776445637812e-06,1.0896465867382688e-06,5.448232933691344e-07,-0.5095541401273885,-0.2480872413279438,0.31653232059908165,0.48286150769923053,inf,,,,0.2411889596602972,0.002160458601284739,0.46668094055661874,0.5579358176779993,-0.22709163346613548,-0.48744459756365854,-0.3512689177020904,0.0032463188040573908,0.0,-0.119848105955358,-0.24354074213108956,,-0.6419779862278372,-0.08286477370789076,-0.05349335305515379,0.4208221441812575,-0.4590674459280747,-0.12977520611857843,-0.0612832271284115,0.22799049570208588,,,,,,,,,,,,,,,,,-0.7701149425287357,-0.5307183315015274,-0.36444284271155863,-0.21633904552804584,inf,,,,-0.06553811790983366,-0.055647739910089644,-0.057487736119929946,-0.006364811867603115,0.16879195614575093,0.021041281874202216,-0.011723127066035777,0.0036235233425136125,,,,,-0.08692705980470516,-0.04377192033017888,-0.036993618547760176,0.019621263054354486,0.05817364098553002,-0.022502761204861572,-0.07722453380092342,0.06122883181983528,,,,,,,,,,,,,,,,,0.22585060617911612,0.020090578658283526,-0.04763295558591722,0.2083444350915297,-0.0018825392464995039,0.0015147799568144087,-0.007336393863065327,0.15672977514859107,,,,,,,,,-1.0,-0.4745665930326593,5.725250896505107,,-0.01065934153939796,-0.0035210776118875056,-0.007441265053666291,0.1549201128942384,,,,,-0.395264116575592,-0.1865629279008262,,,0.007246752285428704,-0.003407937470548091,-0.013535632942008569,0.15767549197000838,,,,,0.0,0.0,0.0,,0.15107913669064743,0.052362897719709,0.02133157646284305,-11.578640183514375,,,,,,,,,0.1554861469386617,0.05390588275097422,0.021976193271327826,-0.026535935360337957,-0.16049733345956008,-0.06656345621123345,-0.05249711761251439,0.0004985541949238837,-0.8875343406593407,-0.28802782118552855,-0.20234152075736517,-0.13652952987521397,-0.08692705980470516,-0.04377192033017888,-0.036993618547760176,0.019621263054354486,0.7824752812819638,-0.544334711468503,2.2386840015744873,-0.5343462708073151,-0.07511266900350522,-0.06670473615336536,-0.07930447003284007,-0.07521438333961057,0.08385416666666656,inf,,,,,,,-37.107734806629836,-12.793941858155279,-7.522954274737394,-6.085031032393271,-0.9045226130653267,-1.6199007440502247,-1.314055410795309,5.921127521232465,,,,,-1.1763485477178424,-1.9838221839212318,-1.4710920330169477,-0.22013885208971923,-0.9892530084008174,-0.21537821468853993,0.17786802632653254,-1.728945663937972,-3.696219931271478,-4.024299224045088,-3.291712721759702,-1.5635731162885302,0.9776091783863805,-0.22923888341655455,-0.028048744238505164,7.345679696927692,355.0,117.92301587301587,70.49702097726603,35.38337477222474,-0.45962732919254656,-inf,,,,,,,0.0,-0.0913308913308913,,,-327.6666666666667,-inf,,,-0.4031620553359684,2.435788086817835,1.162901956174718,0.6742893416488338,0.07425213675213671,-0.05716842212427131,-0.028339725000428785,-inf,,,,,,,,,,,,,0.362530413625304,inf,inf,,0.6036639857015191,-0.7733662269504964,-0.403976077214472,-0.46529741550571824,,,,,0.7722861656510946,-0.28330390166784225,-1.5243235195833806,11.067498040076,-0.47927982911199263,0.3461795083592864,0.6730923704114198,0.6611415326053998,-0.2128651037663336,2.1235878100788264,1.6227651233979394,1.0720896495792607,0.7557879014189695,-0.4308996025137999,-0.07353862536141682,-0.4313010307607188,-0.22264875239923232,-0.15460173832808877,-0.0362761020894953,0.07156359952745456,-0.020044543429844075,-0.10531246685756708,-0.006707994389450467,0.0892499898659783,-0.020044543429844075,-0.10531246685756708,-0.006707994389450467,0.09018051344379047,2.0,0.5619047619047618,0.21561507936507934,0.3376029942279942,,,,,0.0,0.0,0.0,0.1,-0.01982378854625544,-0.10466822054518225,-0.006810148916971093,0.08992175401129723,-0.2300461794659724,-0.09360725997274781,0.08076632757093269,-5.641478215957795,,,,,-0.004425965665236009,-0.024416608001356255,-0.012449024751313532,0.12788808817637193,0.5002087087336413,-2.208933597682585,-3.9235526170032755,-1.2404696911650321,-0.08692705980470516,-0.04377192033017888,-0.036993618547760176,0.019621263054354486,-3.131064446053584,-1.5610317345438391,0.0469900880604035,1.8708003275628091,-1.0039147455415398,-0.7245673903153184,112.89272259197692,54.95831446809499,-3.2151603498542274,-1.333807069197359,-0.4030556681429055,-1.4265642485582943,0.1554861469386617,0.05390588275097422,0.021976193271327826,-0.026535935360337957,0.1554861469386617,0.05390588275097422,0.021976193271327826,-0.026535935360337957,0.1554861469386617,0.05390588275097422,0.021976193271327826,-0.026535935360337957,4.12791095642809,0.569491890064283,0.5174401456010539,-0.1728853173690339,-2.809179775944151,inf,inf,inf,,,,,1.770016542540592,0.384980901218637,2.5756055347736106,1.2027475979558813,1.9076490357831304,0.7243595589470774,0.4425869186269738,0.2879481690420335,1.7012031887482166,0.6391635837300506,0.3527990337944843,0.09134434746631846,-1.0114333095346348,-0.7107888252258627,121.70422795230027,59.4492468635889,-7.223934401724127,-2.899739760489536,-0.7915505033622343,1.2106359843058203,-7.469542829793104,-2.7092836711299655,-1.2034741681322214,-1.7121405540467607,-1.4104447065264387,0.43699897170066465,1.0115629463055416,-0.28647209791639666,1.8569766183834502,0.4233770617161993,2.13448643403473,0.9873780213861899,-0.6576035835160783,-0.29782632489549,-0.1829700768752856,-0.029757965546950326,-3.3833138558210023,-1.5125107026892592,-0.08070657823978653,1.7232801072984327,0.7557783355296175,-0.4309027911435839,-0.07354053853928721,-0.43130198734965397,354.99806043964276,117.9223693528968,70.49663306519459,35.38318081618901,0.15547985161527977,0.05390378430984688,0.02197493420665142,-0.026536564892676397,,,,,-0.0018825392464995039,0.0015147799568144087,-0.007336393863065327,0.15642419462362467,-0.13619262039799684,-0.04474368142635332,-0.02446635462092104,-0.2427831208639192,-0.5086291151520751,-0.24495169461707866,0.33775177360067266,0.39549316816608987,0.22284761309151557,-0.010401924568681498,0.37148968487934714,0.2083054996050818,0.22515401360513376,-0.006888277769823592,0.39089998689257044,0.1553465764692321,-0.011498500743328921,0.00752206507142091,-0.01078618766680033,0.15405161426894792,-0.010943751470934293,0.008252681583298985,-0.010246016683403502,0.17947961009605068,-0.9892530084008174,-0.21537821468853993,0.17786802632653254,-1.728945663937972,-0.5587288113696243,-0.09473091275378927,0.03572240035165701,0.05869599534152388,-0.5531467344378851,-0.3048192391490077,6.558778251060457,3.3817629684971315,1.2945355207726363,0.30698720086794445,0.585175272933123,0.5504908437509248,0.359353568615036,0.04079045347261586,0.5009714563220417,0.5389038192466676,0.06089597822256709,-0.03129481176390636,-0.06966427694936239,-0.32782221703512876,0.34255496161886256,0.06804931266858005,-0.00893835406612753,0.1195850879215059,-1.00393214909844,-0.7164329358001646,112.96425974824244,55.05323700454162,-2.8070394048739065,-1.1722484300690565,-0.1768724946202947,-1.231540100255285,0.012512416605959364,-0.05439564868868844,0.6276835347614356,0.5990721469284908,-0.9882298651881152,-0.20030717688388733,0.20413036513306843,-1.737033232669538,0.08352861519364985,0.045964910225242704,0.03330818934019899,0.10680370339580487,0.09314099324859604,0.05145287665269782,0.03360902437194069,0.10722534393809831,0.08260956572126954,0.058750678897250753,0.030969969382478802,0.1047448170507808,-0.13619262039799684,-0.04474368142635332,-0.02446635462092104,-0.2427831208639192,-0.12829179739279217,-0.04950429145191678,-0.03069296786506781,-0.25630304088807065,-0.14451462540195648,-0.039198174525911865,-0.02865027851216413,-0.24681854324646274,0.2654916119751811,0.10974325448502165,0.06657813601682441,0.4916541896877126,-0.20979326094528683,-0.08422732819881384,-0.05050214806802942,-0.2671982506594227,-0.12829179739279217,-0.04950429145191678,-0.03069296786506781,-0.25630304088807065,1.3104474650743518,1.394762561687421,0.5895518706924332,-0.43109150028217175,0.2435299536021509,0.005767994967663374,0.4881835873515179,0.4707090750415125,-3.1992231246495058,-1.3254750712434868,-0.37567117496684077,-1.5013518911685169,0.7652171327414046,-0.4197258839395395,-0.05884690063628133,-0.32965456706568086,1.3542611794440704,1.337947903424902,0.5584360646517005,-0.45101855768087284,-0.0025482235495773997,-0.025539106276377416,-0.004651703520911021,0.00247198350114215,-0.6541120212111169,-0.30399297412950294,-0.17254896681840276,-0.03170885251433479,,,,,-2.24274393766688,-1.1633726857386248,-10.906790893758023,-18.139765493215492,0.5426193433858497,-0.5999218858587879,2.35723552817407,1.1196787171317442,-3.7123260038031853,-1.4716430485423946,-0.17959965882918477,1.497265129924672,-0.2348447789275635,-0.08032983203504551,-0.04615068004441451,-0.015724034709903745,-4.5448049351367,-1.753635045925991,-0.33537068672622417,1.606075477284947,-0.15452394032878336,-0.05458819640283522,-0.026150295895740805,0.0032976852273017055,-1.0046302263639046,-0.7271011376539355,115.85072521550607,56.416421000775244,-3.6200154629045853,-1.4699207361695896,-0.48782422548079846,-1.4871995749822897,-0.6250044581694431,-0.2782413136420289,-0.16065861318859478,-0.040399269166240946,-0.5202367878284627,-57.72281635277329,-34.40163337998752,,2.586171479259553,0.44357233007909563,-0.7659437954853677,3.9254790248403753,-0.3018632433184594,0.0005538330411185936,-0.03727763109121825,-0.07355996456396649,-1.645067659974999,-0.9990951615228386,0.1152855301632874,0.4531131699316786,-1.645067659974999,-0.9990951615228386,0.1152855301632874,0.4531131699316786,0.9606593112322472,-2.0974962945573763,-3.789266401875355,-1.1889084753787196,-3.5205497206890746,-1.6901434729987164,-0.08664957314974546,2.01703368025425,0.7743952552802413,-2.1762093922818853,-3.792869237343383,-1.2261142470183632,-1.0042874401038568,-0.7262401025673787,118.4526710035575,57.80867741863737,-1.0042874401038568,-0.7262401025673787,118.4526710035575,57.80867741863737,-3.9705469129586217,-1.5655845546120941,-0.19245136588794712,1.203619786788891,0.5426193433858497,-0.5999218858587879,2.35723552817407,1.1196787171317442,-2.917080837120428,-1.230042628496475,-0.324106729337475,-1.3934207639618659,0.5485254006137059,-0.5986543156568348,2.353670978543451,17.526882144728543,,,,,,,,,388.8921809290023,129.24191033007364,77.29000607792872,38.76216698939641,,,,,0.2606650422083978,0.10801210927597231,0.06582331485173562,-7.614468495935563,0.09520275541854573,-0.08237758155653703,-0.21716450281934377,,-0.8954329027489831,-1.569405013665792,-1.2791549069765211,7.429267096875927,0.0,0.0,0.0,0.0,,,,,,,,
